datetime,holiday,workingday,casual,registered,count
2011-01-01 00:00:00,0,0,3,13,16
2011-01-01 01:00:00,0,0,8,32,40
2011-01-01 02:00:00,0,0,5,27,32
2011-01-01 03:00:00,0,0,3,10,13
2011-01-01 04:00:00,0,0,0,1,1
2011-01-01 05:00:00,0,0,0,1,1
2011-01-01 06:00:00,0,0,2,0,2
2011-01-01 07:00:00,0,0,1,2,3
2011-01-01 08:00:00,0,0,1,7,8
2011-01-01 09:00:00,0,0,8,6,14
2011-01-01 10:00:00,0,0,12,24,36
2011-01-01 11:00:00,0,0,26,30,56
2011-01-01 12:00:00,0,0,29,55,84
2011-01-01 13:00:00,0,0,47,47,94
2011-01-01 14:00:00,0,0,35,71,106
2011-01-01 15:00:00,0,0,40,70,110
2011-01-01 16:00:00,0,0,41,52,93
2011-01-01 17:00:00,0,0,15,52,67
2011-01-01 18:00:00,0,0,9,26,35
2011-01-01 19:00:00,0,0,6,31,37
2011-01-01 20:00:00,0,0,11,25,36
2011-01-01 21:00:00,0,0,3,31,34
2011-01-01 22:00:00,0,0,11,17,28
2011-01-01 23:00:00,0,0,15,24,39
2011-01-02 00:00:00,0,0,4,13,17
2011-01-02 01:00:00,0,0,1,16,17
2011-01-02 02:00:00,0,0,1,8,9
2011-01-02 03:00:00,0,0,2,4,6
2011-01-02 04:00:00,0,0,2,1,3
2011-01-02 06:00:00,0,0,0,2,2
2011-01-02 07:00:00,0,0,0,1,1
2011-01-02 08:00:00,0,0,0,8,8
2011-01-02 09:00:00,0,0,1,19,20
2011-01-02 10:00:00,0,0,7,46,53
2011-01-02 11:00:00,0,0,16,54,70
2011-01-02 12:00:00,0,0,20,73,93
2011-01-02 13:00:00,0,0,11,64,75
2011-01-02 14:00:00,0,0,4,55,59
2011-01-02 15:00:00,0,0,19,55,74
2011-01-02 16:00:00,0,0,9,67,76
2011-01-02 17:00:00,0,0,7,58,65
2011-01-02 18:00:00,0,0,10,43,53
2011-01-02 19:00:00,0,0,1,29,30
2011-01-02 20:00:00,0,0,5,17,22
2011-01-02 21:00:00,0,0,11,20,31
2011-01-02 22:00:00,0,0,0,9,9
2011-01-02 23:00:00,0,0,0,8,8
2011-01-03 00:00:00,0,1,0,5,5
2011-01-03 01:00:00,0,1,0,2,2
2011-01-03 04:00:00,0,1,0,1,1
2011-01-03 05:00:00,0,1,0,3,3
2011-01-03 06:00:00,0,1,0,30,30
2011-01-03 07:00:00,0,1,1,63,64
2011-01-03 08:00:00,0,1,1,153,154
2011-01-03 09:00:00,0,1,7,81,88
2011-01-03 10:00:00,0,1,11,33,44
2011-01-03 11:00:00,0,1,10,41,51
2011-01-03 12:00:00,0,1,13,48,61
2011-01-03 13:00:00,0,1,8,53,61
2011-01-03 14:00:00,0,1,11,66,77
2011-01-03 15:00:00,0,1,14,58,72
2011-01-03 16:00:00,0,1,9,67,76
2011-01-03 17:00:00,0,1,11,146,157
2011-01-03 18:00:00,0,1,9,148,157
2011-01-03 19:00:00,0,1,8,102,110
2011-01-03 20:00:00,0,1,3,49,52
2011-01-03 21:00:00,0,1,3,49,52
2011-01-03 22:00:00,0,1,0,20,20
2011-01-03 23:00:00,0,1,1,11,12
2011-01-04 00:00:00,0,1,0,5,5
2011-01-04 01:00:00,0,1,0,2,2
2011-01-04 02:00:00,0,1,0,1,1
2011-01-04 04:00:00,0,1,0,2,2
2011-01-04 05:00:00,0,1,0,4,4
2011-01-04 06:00:00,0,1,0,36,36
2011-01-04 07:00:00,0,1,2,92,94
2011-01-04 08:00:00,0,1,2,177,179
2011-01-04 09:00:00,0,1,2,98,100
2011-01-04 10:00:00,0,1,5,37,42
2011-01-04 11:00:00,0,1,7,50,57
2011-01-04 12:00:00,0,1,12,66,78
2011-01-04 13:00:00,0,1,18,79,97
2011-01-04 14:00:00,0,1,9,54,63
2011-01-04 15:00:00,0,1,17,48,65
2011-01-04 16:00:00,0,1,15,68,83
2011-01-04 17:00:00,0,1,10,202,212
2011-01-04 18:00:00,0,1,3,179,182
2011-01-04 19:00:00,0,1,2,110,112
2011-01-04 20:00:00,0,1,1,53,54
2011-01-04 21:00:00,0,1,0,48,48
2011-01-04 22:00:00,0,1,1,34,35
2011-01-04 23:00:00,0,1,2,9,11
2011-01-05 00:00:00,0,1,0,6,6
2011-01-05 01:00:00,0,1,0,6,6
2011-01-05 02:00:00,0,1,0,2,2
2011-01-05 04:00:00,0,1,0,2,2
2011-01-05 05:00:00,0,1,0,3,3
2011-01-05 06:00:00,0,1,0,33,33
2011-01-05 07:00:00,0,1,1,87,88
2011-01-05 08:00:00,0,1,3,192,195
2011-01-05 09:00:00,0,1,6,109,115
2011-01-05 10:00:00,0,1,4,53,57
2011-01-05 11:00:00,0,1,12,34,46
2011-01-05 12:00:00,0,1,5,74,79
2011-01-05 13:00:00,0,1,6,65,71
2011-01-05 14:00:00,0,1,10,52,62
2011-01-05 15:00:00,0,1,7,55,62
2011-01-05 16:00:00,0,1,4,85,89
2011-01-05 17:00:00,0,1,4,186,190
2011-01-05 18:00:00,0,1,3,166,169
2011-01-05 19:00:00,0,1,5,127,132
2011-01-05 20:00:00,0,1,7,82,89
2011-01-05 21:00:00,0,1,3,40,43
2011-01-05 22:00:00,0,1,1,41,42
2011-01-05 23:00:00,0,1,1,18,19
2011-01-06 00:00:00,0,1,0,11,11
2011-01-06 01:00:00,0,1,0,4,4
2011-01-06 02:00:00,0,1,0,2,2
2011-01-06 04:00:00,0,1,0,1,1
2011-01-06 05:00:00,0,1,0,4,4
2011-01-06 06:00:00,0,1,0,36,36
2011-01-06 07:00:00,0,1,0,95,95
2011-01-06 08:00:00,0,1,3,216,219
2011-01-06 09:00:00,0,1,6,116,122
2011-01-06 10:00:00,0,1,3,42,45
2011-01-06 11:00:00,0,1,2,57,59
2011-01-06 12:00:00,0,1,6,78,84
2011-01-06 13:00:00,0,1,12,55,67
2011-01-06 14:00:00,0,1,11,59,70
2011-01-06 15:00:00,0,1,8,54,62
2011-01-06 16:00:00,0,1,12,74,86
2011-01-06 17:00:00,0,1,9,163,172
2011-01-06 18:00:00,0,1,5,158,163
2011-01-06 19:00:00,0,1,3,109,112
2011-01-06 20:00:00,0,1,3,66,69
2011-01-06 21:00:00,0,1,0,48,48
2011-01-06 22:00:00,0,1,1,51,52
2011-01-06 23:00:00,0,1,4,19,23
2011-01-07 00:00:00,0,1,4,13,17
2011-01-07 01:00:00,0,1,2,5,7
2011-01-07 02:00:00,0,1,0,1,1
2011-01-07 04:00:00,0,1,0,1,1
2011-01-07 05:00:00,0,1,0,5,5
2011-01-07 06:00:00,0,1,8,26,34
2011-01-07 07:00:00,0,1,8,76,84
2011-01-07 08:00:00,0,1,20,190,210
2011-01-07 09:00:00,0,1,9,125,134
2011-01-07 10:00:00,0,1,16,47,63
2011-01-07 11:00:00,0,1,19,48,67
2011-01-07 12:00:00,0,1,9,50,59
2011-01-07 13:00:00,0,1,9,64,73
2011-01-07 14:00:00,0,1,7,43,50
2011-01-07 15:00:00,0,1,9,63,72
2011-01-07 16:00:00,0,1,5,82,87
2011-01-07 17:00:00,0,1,9,178,187
2011-01-07 18:00:00,0,1,7,116,123
2011-01-07 19:00:00,0,1,3,92,95
2011-01-07 20:00:00,0,1,1,50,51
2011-01-07 21:00:00,0,1,0,39,39
2011-01-07 22:00:00,0,1,2,34,36
2011-01-07 23:00:00,0,1,1,14,15
2011-01-08 00:00:00,0,0,1,24,25
2011-01-08 01:00:00,0,0,1,15,16
2011-01-08 02:00:00,0,0,3,13,16
2011-01-08 03:00:00,0,0,0,7,7
2011-01-08 04:00:00,0,0,0,1,1
2011-01-08 05:00:00,0,0,0,5,5
2011-01-08 06:00:00,0,0,0,2,2
2011-01-08 07:00:00,0,0,1,8,9
2011-01-08 08:00:00,0,0,0,15,15
2011-01-08 09:00:00,0,0,0,20,20
2011-01-08 10:00:00,0,0,5,56,61
2011-01-08 11:00:00,0,0,2,60,62
2011-01-08 12:00:00,0,0,8,90,98
2011-01-08 13:00:00,0,0,7,95,102
2011-01-08 14:00:00,0,0,12,83,95
2011-01-08 15:00:00,0,0,5,69,74
2011-01-08 16:00:00,0,0,8,68,76
2011-01-08 17:00:00,0,0,5,64,69
2011-01-08 18:00:00,0,0,3,52,55
2011-01-08 19:00:00,0,0,4,26,30
2011-01-08 20:00:00,0,0,0,28,28
2011-01-08 21:00:00,0,0,2,35,37
2011-01-08 22:00:00,0,0,1,33,34
2011-01-08 23:00:00,0,0,0,22,22
2011-01-09 00:00:00,0,0,1,24,25
2011-01-09 01:00:00,0,0,0,12,12
2011-01-09 02:00:00,0,0,0,11,11
2011-01-09 03:00:00,0,0,0,4,4
2011-01-09 04:00:00,0,0,0,1,1
2011-01-09 05:00:00,0,0,0,1,1
2011-01-09 06:00:00,0,0,0,1,1
2011-01-09 07:00:00,0,0,1,5,6
2011-01-09 08:00:00,0,0,0,10,10
2011-01-09 09:00:00,0,0,0,19,19
2011-01-09 10:00:00,0,0,0,49,49
2011-01-09 11:00:00,0,0,2,47,49
2011-01-09 12:00:00,0,0,4,79,83
2011-01-09 13:00:00,0,0,6,69,75
2011-01-09 14:00:00,0,0,8,64,72
2011-01-09 15:00:00,0,0,5,77,82
2011-01-09 16:00:00,0,0,13,79,92
2011-01-09 17:00:00,0,0,3,59,62
2011-01-09 18:00:00,0,0,4,44,48
2011-01-09 19:00:00,0,0,1,40,41
2011-01-09 20:00:00,0,0,0,38,38
2011-01-09 21:00:00,0,0,1,19,20
2011-01-09 22:00:00,0,0,5,10,15
2011-01-09 23:00:00,0,0,0,6,6
2011-01-10 00:00:00,0,1,2,3,5
2011-01-10 01:00:00,0,1,1,0,1
2011-01-10 02:00:00,0,1,0,3,3
2011-01-10 03:00:00,0,1,0,1,1
2011-01-10 04:00:00,0,1,1,2,3
2011-01-10 05:00:00,0,1,0,3,3
2011-01-10 06:00:00,0,1,0,31,31
2011-01-10 07:00:00,0,1,2,75,77
2011-01-10 08:00:00,0,1,4,184,188
2011-01-10 09:00:00,0,1,2,92,94
2011-01-10 10:00:00,0,1,0,31,31
2011-01-10 11:00:00,0,1,2,28,30
2011-01-10 12:00:00,0,1,5,47,52
2011-01-10 13:00:00,0,1,4,50,54
2011-01-10 14:00:00,0,1,0,47,47
2011-01-10 15:00:00,0,1,2,43,45
2011-01-10 16:00:00,0,1,4,70,74
2011-01-10 17:00:00,0,1,4,174,178
2011-01-10 18:00:00,0,1,1,154,155
2011-01-10 19:00:00,0,1,3,92,95
2011-01-10 20:00:00,0,1,1,73,74
2011-01-10 21:00:00,0,1,1,37,38
2011-01-10 22:00:00,0,1,2,22,24
2011-01-10 23:00:00,0,1,0,18,18
2011-01-11 00:00:00,0,1,2,10,12
2011-01-11 01:00:00,0,1,0,3,3
2011-01-11 02:00:00,0,1,0,3,3
2011-01-11 05:00:00,0,1,0,6,6
2011-01-11 06:00:00,0,1,0,27,27
2011-01-11 07:00:00,0,1,2,97,99
2011-01-11 08:00:00,0,1,3,214,217
2011-01-11 09:00:00,0,1,3,127,130
2011-01-11 10:00:00,0,1,3,51,54
2011-01-11 11:00:00,0,1,4,31,35
2011-01-11 12:00:00,0,1,2,55,57
2011-01-11 13:00:00,0,1,6,46,52
2011-01-11 14:00:00,0,1,3,60,63
2011-01-11 15:00:00,0,1,2,45,47
2011-01-11 16:00:00,0,1,4,72,76
2011-01-11 17:00:00,0,1,6,130,136
2011-01-11 18:00:00,0,1,1,94,95
2011-01-11 19:00:00,0,1,0,51,51
2011-01-11 20:00:00,0,1,0,32,32
2011-01-11 21:00:00,0,1,0,20,20
2011-01-11 22:00:00,0,1,1,28,29
2011-01-11 23:00:00,0,1,1,18,19
2011-01-12 00:00:00,0,1,0,7,7
2011-01-12 01:00:00,0,1,0,6,6
2011-01-12 02:00:00,0,1,0,1,1
2011-01-12 05:00:00,0,1,0,5,5
2011-01-12 06:00:00,0,1,0,16,16
2011-01-12 07:00:00,0,1,0,54,54
2011-01-12 08:00:00,0,1,3,125,128
2011-01-12 09:00:00,0,1,3,78,81
2011-01-12 10:00:00,0,1,0,39,39
2011-01-12 11:00:00,0,1,3,32,35
2011-01-12 12:00:00,0,1,3,52,55
2011-01-12 13:00:00,0,1,0,49,49
2011-01-12 14:00:00,0,1,0,44,44
2011-01-12 15:00:00,0,1,1,48,49
2011-01-12 16:00:00,0,1,5,63,68
2011-01-12 17:00:00,0,1,0,139,139
2011-01-12 18:00:00,0,1,2,135,137
2011-01-12 19:00:00,0,1,1,82,83
2011-01-12 20:00:00,0,1,2,54,56
2011-01-12 21:00:00,0,1,0,57,57
2011-01-12 22:00:00,0,1,1,32,33
2011-01-12 23:00:00,0,1,1,19,20
2011-01-13 00:00:00,0,1,1,6,7
2011-01-13 01:00:00,0,1,0,2,2
2011-01-13 02:00:00,0,1,0,2,2
2011-01-13 03:00:00,0,1,0,3,3
2011-01-13 04:00:00,0,1,0,4,4
2011-01-13 05:00:00,0,1,0,3,3
2011-01-13 06:00:00,0,1,0,28,28
2011-01-13 07:00:00,0,1,0,72,72
2011-01-13 08:00:00,0,1,5,197,202
2011-01-13 09:00:00,0,1,2,137,139
2011-01-13 10:00:00,0,1,2,36,38
2011-01-13 11:00:00,0,1,4,33,37
2011-01-13 12:00:00,0,1,3,49,52
2011-01-13 13:00:00,0,1,2,81,83
2011-01-13 14:00:00,0,1,3,39,42
2011-01-13 15:00:00,0,1,5,55,60
2011-01-13 16:00:00,0,1,2,76,78
2011-01-13 17:00:00,0,1,4,158,162
2011-01-13 18:00:00,0,1,3,141,144
2011-01-13 19:00:00,0,1,1,98,99
2011-01-13 20:00:00,0,1,0,64,64
2011-01-13 21:00:00,0,1,0,40,40
2011-01-13 22:00:00,0,1,0,30,30
2011-01-13 23:00:00,0,1,1,14,15
2011-01-14 00:00:00,0,1,0,14,14
2011-01-14 01:00:00,0,1,0,5,5
2011-01-14 02:00:00,0,1,0,1,1
2011-01-14 03:00:00,0,1,0,1,1
2011-01-14 05:00:00,0,1,0,8,8
2011-01-14 06:00:00,0,1,0,17,17
2011-01-14 07:00:00,0,1,0,70,70
2011-01-14 08:00:00,0,1,2,156,158
2011-01-14 09:00:00,0,1,0,117,117
2011-01-14 10:00:00,0,1,4,40,44
2011-01-14 11:00:00,0,1,6,47,53
2011-01-14 12:00:00,0,1,2,59,61
2011-01-14 13:00:00,0,1,4,73,77
2011-01-14 14:00:00,0,1,5,59,64
2011-01-14 15:00:00,0,1,9,59,68
2011-01-14 16:00:00,0,1,3,87,90
2011-01-14 17:00:00,0,1,4,155,159
2011-01-14 18:00:00,0,1,5,134,139
2011-01-14 19:00:00,0,1,3,89,92
2011-01-14 20:00:00,0,1,0,68,68
2011-01-14 21:00:00,0,1,4,48,52
2011-01-14 22:00:00,0,1,2,34,36
2011-01-14 23:00:00,0,1,1,26,27
2011-01-15 00:00:00,0,0,3,25,28
2011-01-15 01:00:00,0,0,2,18,20
2011-01-15 02:00:00,0,0,0,12,12
2011-01-15 03:00:00,0,0,1,7,8
2011-01-15 04:00:00,0,0,0,5,5
2011-01-15 05:00:00,0,0,0,1,1
2011-01-15 06:00:00,0,0,1,2,3
2011-01-15 07:00:00,0,0,1,9,10
2011-01-15 08:00:00,0,0,1,22,23
2011-01-15 09:00:00,0,0,2,31,33
2011-01-15 10:00:00,0,0,2,57,59
2011-01-15 11:00:00,0,0,18,54,72
2011-01-15 12:00:00,0,0,15,74,89
2011-01-15 13:00:00,0,0,21,80,101
2011-01-15 14:00:00,0,0,26,92,118
2011-01-15 15:00:00,0,0,21,108,129
2011-01-15 16:00:00,0,0,33,95,128
2011-01-15 17:00:00,0,0,29,54,83
2011-01-15 18:00:00,0,0,15,69,84
2011-01-15 19:00:00,0,0,14,60,74
2011-01-15 20:00:00,0,0,6,35,41
2011-01-15 21:00:00,0,0,6,51,57
2011-01-15 22:00:00,0,0,0,26,26
2011-01-15 23:00:00,0,0,5,39,44
2011-01-16 00:00:00,0,0,6,33,39
2011-01-16 01:00:00,0,0,4,19,23
2011-01-16 02:00:00,0,0,3,13,16
2011-01-16 03:00:00,0,0,9,6,15
2011-01-16 04:00:00,0,0,0,1,1
2011-01-16 05:00:00,0,0,1,1,2
2011-01-16 06:00:00,0,0,0,1,1
2011-01-16 07:00:00,0,0,0,3,3
2011-01-16 08:00:00,0,0,0,18,18
2011-01-16 09:00:00,0,0,3,29,32
2011-01-16 10:00:00,0,0,8,71,79
2011-01-16 11:00:00,0,0,23,70,93
2011-01-16 12:00:00,0,0,29,75,104
2011-01-16 13:00:00,0,0,23,95,118
2011-01-16 14:00:00,0,0,22,69,91
2011-01-16 15:00:00,0,0,35,78,113
2011-01-16 16:00:00,0,0,22,77,99
2011-01-16 17:00:00,0,0,23,82,105
2011-01-16 18:00:00,0,0,11,56,67
2011-01-16 19:00:00,0,0,14,47,61
2011-01-16 20:00:00,0,0,7,50,57
2011-01-16 21:00:00,0,0,6,22,28
2011-01-16 22:00:00,0,0,2,19,21
2011-01-16 23:00:00,0,0,0,18,18
2011-01-17 00:00:00,1,0,1,16,17
2011-01-17 01:00:00,1,0,1,15,16
2011-01-17 02:00:00,1,0,0,8,8
2011-01-17 03:00:00,1,0,0,2,2
2011-01-17 04:00:00,1,0,1,2,3
2011-01-17 05:00:00,1,0,0,1,1
2011-01-17 06:00:00,1,0,0,5,5
2011-01-17 07:00:00,1,0,4,9,13
2011-01-17 08:00:00,1,0,3,30,33
2011-01-17 09:00:00,1,0,8,39,47
2011-01-17 10:00:00,1,0,7,50,57
2011-01-17 11:00:00,1,0,9,55,64
2011-01-17 12:00:00,1,0,10,70,80
2011-01-17 13:00:00,1,0,13,80,93
2011-01-17 14:00:00,1,0,12,74,86
2011-01-17 15:00:00,1,0,21,72,93
2011-01-17 16:00:00,1,0,6,76,82
2011-01-17 17:00:00,1,0,4,67,71
2011-01-17 18:00:00,1,0,7,85,92
2011-01-17 19:00:00,1,0,2,58,60
2011-01-17 20:00:00,1,0,4,29,33
2011-01-17 21:00:00,1,0,3,24,27
2011-01-17 22:00:00,1,0,0,13,13
2011-01-17 23:00:00,1,0,1,3,4
2011-01-18 12:00:00,0,1,0,3,3
2011-01-18 13:00:00,0,1,0,22,22
2011-01-18 14:00:00,0,1,2,26,28
2011-01-18 15:00:00,0,1,3,32,35
2011-01-18 16:00:00,0,1,0,61,61
2011-01-18 17:00:00,0,1,1,124,125
2011-01-18 18:00:00,0,1,1,132,133
2011-01-18 19:00:00,0,1,1,98,99
2011-01-18 20:00:00,0,1,0,83,83
2011-01-18 21:00:00,0,1,0,41,41
2011-01-18 22:00:00,0,1,0,33,33
2011-01-18 23:00:00,0,1,1,19,20
2011-01-19 00:00:00,0,1,0,3,3
2011-01-19 01:00:00,0,1,1,6,7
2011-01-19 02:00:00,0,1,0,3,3
2011-01-19 04:00:00,0,1,1,1,2
2011-01-19 05:00:00,0,1,0,7,7
2011-01-19 06:00:00,0,1,0,32,32
2011-01-19 07:00:00,0,1,1,89,90
2011-01-19 08:00:00,0,1,1,196,197
2011-01-19 09:00:00,0,1,2,107,109
2011-01-19 10:00:00,0,1,1,46,47
2011-01-19 11:00:00,0,1,5,47,52
2011-01-19 12:00:00,0,1,5,65,70
2011-01-19 13:00:00,0,1,11,67,78
2011-01-19 14:00:00,0,1,7,68,75
2011-01-19 15:00:00,0,1,4,78,82
2011-01-19 16:00:00,0,1,10,94,104
2011-01-19 17:00:00,0,1,7,190,197
2011-01-19 18:00:00,0,1,5,156,161
2011-01-19 19:00:00,0,1,4,108,112
2011-01-19 20:00:00,0,1,2,74,76
2011-01-19 21:00:00,0,1,4,55,59
2011-01-19 22:00:00,0,1,6,53,59
2011-01-19 23:00:00,0,1,1,27,28
2011-02-01 00:00:00,0,1,2,6,8
2011-02-01 01:00:00,0,1,0,3,3
2011-02-01 02:00:00,0,1,0,2,2
2011-02-01 03:00:00,0,1,0,2,2
2011-02-01 05:00:00,0,1,0,3,3
2011-02-01 06:00:00,0,1,0,22,22
2011-02-01 07:00:00,0,1,0,52,52
2011-02-01 08:00:00,0,1,3,132,135
2011-02-01 09:00:00,0,1,2,114,116
2011-02-01 10:00:00,0,1,0,47,47
2011-02-01 11:00:00,0,1,2,49,51
2011-02-01 12:00:00,0,1,2,53,55
2011-02-01 13:00:00,0,1,3,49,52
2011-02-01 14:00:00,0,1,5,49,54
2011-02-01 15:00:00,0,1,7,45,52
2011-02-01 16:00:00,0,1,3,61,64
2011-02-01 17:00:00,0,1,4,172,176
2011-02-01 18:00:00,0,1,3,165,168
2011-02-01 19:00:00,0,1,3,105,108
2011-02-01 20:00:00,0,1,5,69,74
2011-02-01 21:00:00,0,1,0,64,64
2011-02-01 22:00:00,0,1,2,34,36
2011-02-01 23:00:00,0,1,1,15,16
2011-02-02 00:00:00,0,1,0,2,2
2011-02-02 01:00:00,0,1,0,3,3
2011-02-02 02:00:00,0,1,4,0,4
2011-02-02 03:00:00,0,1,0,1,1
2011-02-02 04:00:00,0,1,0,1,1
2011-02-02 05:00:00,0,1,0,3,3
2011-02-02 06:00:00,0,1,1,17,18
2011-02-02 07:00:00,0,1,1,48,49
2011-02-02 08:00:00,0,1,1,154,155
2011-02-02 09:00:00,0,1,4,119,123
2011-02-02 10:00:00,0,1,2,59,61
2011-02-02 11:00:00,0,1,5,47,52
2011-02-02 12:00:00,0,1,3,61,64
2011-02-02 13:00:00,0,1,1,74,75
2011-02-02 14:00:00,0,1,2,61,63
2011-02-02 15:00:00,0,1,10,66,76
2011-02-02 16:00:00,0,1,8,95,103
2011-02-02 17:00:00,0,1,7,183,190
2011-02-02 18:00:00,0,1,7,175,182
2011-02-02 19:00:00,0,1,3,88,91
2011-02-02 20:00:00,0,1,4,71,75
2011-02-02 21:00:00,0,1,1,62,63
2011-02-02 22:00:00,0,1,5,35,40
2011-02-02 23:00:00,0,1,3,29,32
2011-02-03 00:00:00,0,1,1,11,12
2011-02-03 01:00:00,0,1,0,5,5
2011-02-03 02:00:00,0,1,0,2,2
2011-02-03 03:00:00,0,1,0,1,1
2011-02-03 05:00:00,0,1,0,2,2
2011-02-03 06:00:00,0,1,0,39,39
2011-02-03 07:00:00,0,1,1,86,87
2011-02-03 08:00:00,0,1,4,184,188
2011-02-03 09:00:00,0,1,6,127,133
2011-02-03 10:00:00,0,1,2,50,52
2011-02-03 11:00:00,0,1,9,55,64
2011-02-03 12:00:00,0,1,2,67,69
2011-02-03 13:00:00,0,1,4,47,51
2011-02-03 14:00:00,0,1,4,43,47
2011-02-03 15:00:00,0,1,4,56,60
2011-02-03 16:00:00,0,1,5,73,78
2011-02-03 17:00:00,0,1,5,170,175
2011-02-03 18:00:00,0,1,2,145,147
2011-02-03 19:00:00,0,1,4,92,96
2011-02-03 20:00:00,0,1,1,108,109
2011-02-03 21:00:00,0,1,1,53,54
2011-02-03 22:00:00,0,1,2,39,41
2011-02-03 23:00:00,0,1,4,34,38
2011-02-04 00:00:00,0,1,3,10,13
2011-02-04 01:00:00,0,1,0,7,7
2011-02-04 02:00:00,0,1,0,1,1
2011-02-04 03:00:00,0,1,0,1,1
2011-02-04 05:00:00,0,1,0,7,7
2011-02-04 06:00:00,0,1,2,26,28
2011-02-04 07:00:00,0,1,0,87,87
2011-02-04 08:00:00,0,1,3,217,220
2011-02-04 09:00:00,0,1,3,124,127
2011-02-04 10:00:00,0,1,5,46,51
2011-02-04 11:00:00,0,1,3,61,64
2011-02-04 12:00:00,0,1,8,78,86
2011-02-04 13:00:00,0,1,9,73,82
2011-02-04 14:00:00,0,1,15,76,91
2011-02-04 15:00:00,0,1,9,81,90
2011-02-04 16:00:00,0,1,8,91,99
2011-02-04 17:00:00,0,1,10,195,205
2011-02-04 18:00:00,0,1,3,152,155
2011-02-04 19:00:00,0,1,1,102,103
2011-02-04 20:00:00,0,1,2,69,71
2011-02-04 21:00:00,0,1,2,41,43
2011-02-04 22:00:00,0,1,1,45,46
2011-02-04 23:00:00,0,1,1,30,31
2011-02-05 00:00:00,0,0,3,36,39
2011-02-05 01:00:00,0,0,1,17,18
2011-02-05 02:00:00,0,0,5,12,17
2011-02-05 03:00:00,0,0,1,10,11
2011-02-05 04:00:00,0,0,0,8,8
2011-02-05 05:00:00,0,0,0,9,9
2011-02-05 06:00:00,0,0,0,4,4
2011-02-05 07:00:00,0,0,0,4,4
2011-02-05 08:00:00,0,0,0,10,10
2011-02-05 09:00:00,0,0,3,17,20
2011-02-05 10:00:00,0,0,3,31,34
2011-02-05 11:00:00,0,0,1,46,47
2011-02-05 12:00:00,0,0,10,42,52
2011-02-05 13:00:00,0,0,10,62,72
2011-02-05 14:00:00,0,0,5,50,55
2011-02-05 15:00:00,0,0,11,49,60
2011-02-05 16:00:00,0,0,8,63,71
2011-02-05 17:00:00,0,0,14,64,78
2011-02-05 18:00:00,0,0,2,81,83
2011-02-05 19:00:00,0,0,6,78,84
2011-02-05 20:00:00,0,0,5,64,69
2011-02-05 21:00:00,0,0,3,53,56
2011-02-05 22:00:00,0,0,2,43,45
2011-02-05 23:00:00,0,0,7,52,59
2011-02-06 00:00:00,0,0,2,37,39
2011-02-06 01:00:00,0,0,4,40,44
2011-02-06 02:00:00,0,0,0,20,20
2011-02-06 03:00:00,0,0,3,10,13
2011-02-06 04:00:00,0,0,0,2,2
2011-02-06 05:00:00,0,0,0,1,1
2011-02-06 06:00:00,0,0,0,1,1
2011-02-06 07:00:00,0,0,0,8,8
2011-02-06 08:00:00,0,0,2,21,23
2011-02-06 09:00:00,0,0,7,38,45
2011-02-06 10:00:00,0,0,15,74,89
2011-02-06 11:00:00,0,0,28,89,117
2011-02-06 12:00:00,0,0,48,126,174
2011-02-06 13:00:00,0,0,47,135,182
2011-02-06 14:00:00,0,0,47,114,161
2011-02-06 15:00:00,0,0,52,130,182
2011-02-06 16:00:00,0,0,42,115,157
2011-02-06 17:00:00,0,0,24,97,121
2011-02-06 18:00:00,0,0,13,65,78
2011-02-06 19:00:00,0,0,1,20,21
2011-02-06 20:00:00,0,0,5,21,26
2011-02-06 21:00:00,0,0,5,22,27
2011-02-06 22:00:00,0,0,5,57,62
2011-02-06 23:00:00,0,0,4,26,30
2011-02-07 00:00:00,0,1,1,14,15
2011-02-07 01:00:00,0,1,1,4,5
2011-02-07 02:00:00,0,1,0,3,3
2011-02-07 03:00:00,0,1,0,1,1
2011-02-07 04:00:00,0,1,1,1,2
2011-02-07 05:00:00,0,1,1,9,10
2011-02-07 06:00:00,0,1,1,29,30
2011-02-07 07:00:00,0,1,6,89,95
2011-02-07 08:00:00,0,1,7,223,230
2011-02-07 09:00:00,0,1,3,115,118
2011-02-07 10:00:00,0,1,6,49,55
2011-02-07 11:00:00,0,1,11,36,47
2011-02-07 12:00:00,0,1,7,59,66
2011-02-07 13:00:00,0,1,10,54,64
2011-02-07 14:00:00,0,1,8,52,60
2011-02-07 15:00:00,0,1,4,46,50
2011-02-07 16:00:00,0,1,16,98,114
2011-02-07 17:00:00,0,1,9,207,216
2011-02-07 18:00:00,0,1,5,170,175
2011-02-07 19:00:00,0,1,5,123,128
2011-02-07 20:00:00,0,1,6,82,88
2011-02-07 21:00:00,0,1,3,75,78
2011-02-07 22:00:00,0,1,3,34,37
2011-02-07 23:00:00,0,1,6,19,25
2011-02-08 00:00:00,0,1,4,6,10
2011-02-08 01:00:00,0,1,0,4,4
2011-02-08 02:00:00,0,1,1,1,2
2011-02-08 03:00:00,0,1,0,1,1
2011-02-08 04:00:00,0,1,0,3,3
2011-02-08 05:00:00,0,1,0,2,2
2011-02-08 06:00:00,0,1,0,39,39
2011-02-08 07:00:00,0,1,3,97,100
2011-02-08 08:00:00,0,1,7,236,243
2011-02-08 09:00:00,0,1,7,128,135
2011-02-08 10:00:00,0,1,4,44,48
2011-02-08 11:00:00,0,1,1,49,50
2011-02-08 12:00:00,0,1,2,63,65
2011-02-08 13:00:00,0,1,2,48,50
2011-02-08 14:00:00,0,1,3,61,64
2011-02-08 15:00:00,0,1,6,45,51
2011-02-08 16:00:00,0,1,4,79,83
2011-02-08 17:00:00,0,1,4,172,176
2011-02-08 18:00:00,0,1,1,151,152
2011-02-08 19:00:00,0,1,1,100,101
2011-02-08 20:00:00,0,1,3,53,56
2011-02-08 21:00:00,0,1,8,46,54
2011-02-08 22:00:00,0,1,0,29,29
2011-02-08 23:00:00,0,1,3,9,12
2011-02-09 00:00:00,0,1,0,17,17
2011-02-09 01:00:00,0,1,0,7,7
2011-02-09 02:00:00,0,1,1,2,3
2011-02-09 03:00:00,0,1,0,2,2
2011-02-09 05:00:00,0,1,0,7,7
2011-02-09 06:00:00,0,1,0,43,43
2011-02-09 07:00:00,0,1,4,95,99
2011-02-09 08:00:00,0,1,1,198,199
2011-02-09 09:00:00,0,1,4,119,123
2011-02-09 10:00:00,0,1,8,51,59
2011-02-09 11:00:00,0,1,1,40,41
2011-02-09 12:00:00,0,1,4,57,61
2011-02-09 13:00:00,0,1,2,67,69
2011-02-09 14:00:00,0,1,2,56,58
2011-02-09 15:00:00,0,1,3,61,64
2011-02-09 16:00:00,0,1,7,72,79
2011-02-09 17:00:00,0,1,9,157,166
2011-02-09 18:00:00,0,1,2,168,170
2011-02-09 19:00:00,0,1,1,87,88
2011-02-09 20:00:00,0,1,0,84,84
2011-02-09 21:00:00,0,1,0,83,83
2011-02-09 22:00:00,0,1,4,42,46
2011-02-09 23:00:00,0,1,0,37,37
2011-02-10 00:00:00,0,1,0,16,16
2011-02-10 01:00:00,0,1,0,7,7
2011-02-10 02:00:00,0,1,0,3,3
2011-02-10 04:00:00,0,1,0,1,1
2011-02-10 05:00:00,0,1,0,6,6
2011-02-10 06:00:00,0,1,0,26,26
2011-02-10 07:00:00,0,1,0,99,99
2011-02-10 08:00:00,0,1,5,173,178
2011-02-10 09:00:00,0,1,1,121,122
2011-02-10 10:00:00,0,1,1,34,35
2011-02-10 11:00:00,0,1,1,44,45
2011-02-10 12:00:00,0,1,4,65,69
2011-02-10 13:00:00,0,1,3,59,62
2011-02-10 14:00:00,0,1,6,42,48
2011-02-10 15:00:00,0,1,0,50,50
2011-02-10 16:00:00,0,1,4,76,80
2011-02-10 17:00:00,0,1,6,159,165
2011-02-10 18:00:00,0,1,3,157,160
2011-02-10 19:00:00,0,1,2,110,112
2011-02-10 20:00:00,0,1,4,93,97
2011-02-10 21:00:00,0,1,2,70,72
2011-02-10 22:00:00,0,1,4,47,51
2011-02-10 23:00:00,0,1,1,33,34
2011-02-11 00:00:00,0,1,2,12,14
2011-02-11 01:00:00,0,1,1,6,7
2011-02-11 02:00:00,0,1,0,3,3
2011-02-11 05:00:00,0,1,0,4,4
2011-02-11 06:00:00,0,1,1,23,24
2011-02-11 07:00:00,0,1,1,73,74
2011-02-11 08:00:00,0,1,4,212,216
2011-02-11 09:00:00,0,1,8,132,140
2011-02-11 10:00:00,0,1,5,39,44
2011-02-11 11:00:00,0,1,12,52,64
2011-02-11 12:00:00,0,1,7,64,71
2011-02-11 13:00:00,0,1,21,89,110
2011-02-11 14:00:00,0,1,17,67,84
2011-02-11 15:00:00,0,1,12,62,74
2011-02-11 16:00:00,0,1,14,111,125
2011-02-11 17:00:00,0,1,18,193,211
2011-02-11 18:00:00,0,1,9,165,174
2011-02-11 19:00:00,0,1,7,94,101
2011-02-11 20:00:00,0,1,2,61,63
2011-02-11 21:00:00,0,1,1,46,47
2011-02-11 22:00:00,0,1,2,41,43
2011-02-11 23:00:00,0,1,5,48,53
2011-02-12 00:00:00,0,0,3,27,30
2011-02-12 01:00:00,0,0,2,22,24
2011-02-12 02:00:00,0,0,2,13,15
2011-02-12 03:00:00,0,0,3,7,10
2011-02-12 04:00:00,0,0,0,4,4
2011-02-12 05:00:00,0,0,0,1,1
2011-02-12 06:00:00,0,0,1,1,2
2011-02-12 07:00:00,0,0,2,9,11
2011-02-12 08:00:00,0,0,2,28,30
2011-02-12 09:00:00,0,0,5,38,43
2011-02-12 10:00:00,0,0,13,71,84
2011-02-12 11:00:00,0,0,30,84,114
2011-02-12 12:00:00,0,0,27,93,120
2011-02-12 13:00:00,0,0,32,103,135
2011-02-12 14:00:00,0,0,30,90,120
2011-02-12 15:00:00,0,0,47,127,174
2011-02-12 16:00:00,0,0,42,103,145
2011-02-12 17:00:00,0,0,24,113,137
2011-02-12 18:00:00,0,0,4,60,64
2011-02-12 19:00:00,0,0,2,39,41
2011-02-12 20:00:00,0,0,1,39,40
2011-02-12 21:00:00,0,0,9,42,51
2011-02-12 22:00:00,0,0,6,39,45
2011-02-12 23:00:00,0,0,1,31,32
2011-02-13 00:00:00,0,0,5,34,39
2011-02-13 01:00:00,0,0,1,23,24
2011-02-13 02:00:00,0,0,1,19,20
2011-02-13 03:00:00,0,0,4,8,12
2011-02-13 04:00:00,0,0,0,2,2
2011-02-13 06:00:00,0,0,2,3,5
2011-02-13 07:00:00,0,0,0,3,3
2011-02-13 08:00:00,0,0,1,11,12
2011-02-13 09:00:00,0,0,12,35,47
2011-02-13 10:00:00,0,0,19,86,105
2011-02-13 11:00:00,0,0,26,86,112
2011-02-13 12:00:00,0,0,58,94,152
2011-02-13 13:00:00,0,0,62,92,154
2011-02-13 14:00:00,0,0,51,110,161
2011-02-13 15:00:00,0,0,40,122,162
2011-02-13 16:00:00,0,0,28,106,134
2011-02-13 17:00:00,0,0,30,95,125
2011-02-13 18:00:00,0,0,17,78,95
2011-02-13 19:00:00,0,0,11,50,61
2011-02-13 20:00:00,0,0,15,32,47
2011-02-13 21:00:00,0,0,6,45,51
2011-02-13 22:00:00,0,0,5,31,36
2011-02-13 23:00:00,0,0,3,27,30
2011-02-14 00:00:00,0,1,3,8,11
2011-02-14 01:00:00,0,1,1,6,7
2011-02-14 02:00:00,0,1,0,2,2
2011-02-14 03:00:00,0,1,1,1,2
2011-02-14 04:00:00,0,1,0,2,2
2011-02-14 05:00:00,0,1,0,3,3
2011-02-14 06:00:00,0,1,1,25,26
2011-02-14 07:00:00,0,1,2,96,98
2011-02-14 08:00:00,0,1,7,249,256
2011-02-14 09:00:00,0,1,8,122,130
2011-02-14 10:00:00,0,1,9,46,55
2011-02-14 11:00:00,0,1,10,43,53
2011-02-14 12:00:00,0,1,27,99,126
2011-02-14 13:00:00,0,1,27,93,120
2011-02-14 14:00:00,0,1,14,76,90
2011-02-14 15:00:00,0,1,19,71,90
2011-02-14 16:00:00,0,1,16,102,118
2011-02-14 17:00:00,0,1,25,218,243
2011-02-14 18:00:00,0,1,11,194,205
2011-02-14 19:00:00,0,1,12,86,98
2011-02-14 20:00:00,0,1,5,65,70
2011-02-14 21:00:00,0,1,8,35,43
2011-02-14 22:00:00,0,1,1,44,45
2011-02-14 23:00:00,0,1,1,19,20
2011-02-15 00:00:00,0,1,7,12,19
2011-02-15 01:00:00,0,1,0,5,5
2011-02-15 02:00:00,0,1,1,2,3
2011-02-15 04:00:00,0,1,0,1,1
2011-02-15 05:00:00,0,1,0,4,4
2011-02-15 06:00:00,0,1,0,30,30
2011-02-15 07:00:00,0,1,2,103,105
2011-02-15 08:00:00,0,1,10,213,223
2011-02-15 09:00:00,0,1,2,108,110
2011-02-15 10:00:00,0,1,5,47,52
2011-02-15 11:00:00,0,1,11,46,57
2011-02-15 12:00:00,0,1,6,65,71
2011-02-15 13:00:00,0,1,14,68,82
2011-02-15 14:00:00,0,1,10,69,79
2011-02-15 15:00:00,0,1,11,74,85
2011-02-15 16:00:00,0,1,21,77,98
2011-02-15 17:00:00,0,1,15,191,206
2011-02-15 18:00:00,0,1,14,198,212
2011-02-15 19:00:00,0,1,3,142,145
2011-02-15 20:00:00,0,1,3,98,101
2011-02-15 21:00:00,0,1,5,61,66
2011-02-15 22:00:00,0,1,0,41,41
2011-02-15 23:00:00,0,1,0,20,20
2011-02-16 00:00:00,0,1,0,15,15
2011-02-16 01:00:00,0,1,0,9,9
2011-02-16 03:00:00,0,1,0,1,1
2011-02-16 04:00:00,0,1,0,1,1
2011-02-16 05:00:00,0,1,0,5,5
2011-02-16 06:00:00,0,1,1,32,33
2011-02-16 07:00:00,0,1,5,103,108
2011-02-16 08:00:00,0,1,6,224,230
2011-02-16 09:00:00,0,1,2,122,124
2011-02-16 10:00:00,0,1,14,55,69
2011-02-16 11:00:00,0,1,7,59,66
2011-02-16 12:00:00,0,1,14,72,86
2011-02-16 13:00:00,0,1,13,80,93
2011-02-16 14:00:00,0,1,17,65,82
2011-02-16 15:00:00,0,1,35,82,117
2011-02-16 16:00:00,0,1,26,96,122
2011-02-16 17:00:00,0,1,11,244,255
2011-02-16 18:00:00,0,1,20,202,222
2011-02-16 19:00:00,0,1,18,143,161
2011-02-16 20:00:00,0,1,10,108,118
2011-02-16 21:00:00,0,1,5,87,92
2011-02-16 22:00:00,0,1,12,61,73
2011-02-16 23:00:00,0,1,2,31,33
2011-02-17 00:00:00,0,1,1,16,17
2011-02-17 01:00:00,0,1,0,6,6
2011-02-17 02:00:00,0,1,2,4,6
2011-02-17 03:00:00,0,1,3,1,4
2011-02-17 04:00:00,0,1,3,1,4
2011-02-17 05:00:00,0,1,1,11,12
2011-02-17 06:00:00,0,1,3,44,47
2011-02-17 07:00:00,0,1,7,119,126
2011-02-17 08:00:00,0,1,18,267,285
2011-02-17 09:00:00,0,1,16,163,179
2011-02-17 10:00:00,0,1,18,70,88
2011-02-17 11:00:00,0,1,19,71,90
2011-02-17 12:00:00,0,1,15,86,101
2011-02-17 13:00:00,0,1,15,108,123
2011-02-17 14:00:00,0,1,26,55,81
2011-02-17 15:00:00,0,1,15,91,106
2011-02-17 16:00:00,0,1,29,117,146
2011-02-17 17:00:00,0,1,18,256,274
2011-02-17 18:00:00,0,1,11,211,222
2011-02-17 19:00:00,0,1,14,161,175
2011-02-17 20:00:00,0,1,8,131,139
2011-02-17 21:00:00,0,1,5,119,124
2011-02-17 22:00:00,0,1,8,68,76
2011-02-17 23:00:00,0,1,4,40,44
2011-02-18 00:00:00,0,1,12,20,32
2011-02-18 01:00:00,0,1,1,7,8
2011-02-18 02:00:00,0,1,2,5,7
2011-02-18 03:00:00,0,1,2,6,8
2011-02-18 04:00:00,0,1,0,1,1
2011-02-18 05:00:00,0,1,1,6,7
2011-02-18 06:00:00,0,1,2,48,50
2011-02-18 07:00:00,0,1,8,108,116
2011-02-18 08:00:00,0,1,26,246,272
2011-02-18 09:00:00,0,1,15,154,169
2011-02-18 10:00:00,0,1,17,78,95
2011-02-18 11:00:00,0,1,31,82,113
2011-02-18 12:00:00,0,1,59,126,185
2011-02-18 13:00:00,0,1,45,131,176
2011-02-18 14:00:00,0,1,73,118,191
2011-02-18 15:00:00,0,1,55,117,172
2011-02-18 16:00:00,0,1,68,164,232
2011-02-18 17:00:00,0,1,52,275,327
2011-02-18 18:00:00,0,1,29,195,224
2011-02-18 19:00:00,0,1,16,146,162
2011-02-18 20:00:00,0,1,19,105,124
2011-02-18 21:00:00,0,1,11,61,72
2011-02-18 22:00:00,0,1,19,88,107
2011-02-18 23:00:00,0,1,16,61,77
2011-02-19 00:00:00,0,0,6,23,29
2011-02-19 01:00:00,0,0,10,21,31
2011-02-19 02:00:00,0,0,3,14,17
2011-02-19 03:00:00,0,0,0,7,7
2011-02-19 04:00:00,0,0,0,3,3
2011-02-19 05:00:00,0,0,0,3,3
2011-02-19 06:00:00,0,0,3,3,6
2011-02-19 07:00:00,0,0,6,16,22
2011-02-19 08:00:00,0,0,9,36,45
2011-02-19 09:00:00,0,0,18,37,55
2011-02-19 10:00:00,0,0,34,72,106
2011-02-19 11:00:00,0,0,47,76,123
2011-02-19 12:00:00,0,0,38,81,119
2011-02-19 13:00:00,0,0,52,103,155
2011-02-19 14:00:00,0,0,102,94,196
2011-02-19 15:00:00,0,0,84,87,171
2011-02-19 16:00:00,0,0,39,81,120
2011-02-19 17:00:00,0,0,36,91,127
2011-02-19 18:00:00,0,0,21,67,88
2011-02-19 19:00:00,0,0,5,54,59
2011-02-19 20:00:00,0,0,9,38,47
2011-02-19 21:00:00,0,0,4,29,33
2011-02-19 22:00:00,0,0,2,42,44
2011-02-19 23:00:00,0,0,4,25,29
2011-03-01 00:00:00,0,1,0,7,7
2011-03-01 01:00:00,0,1,0,3,3
2011-03-01 02:00:00,0,1,0,4,4
2011-03-01 03:00:00,0,1,0,2,2
2011-03-01 04:00:00,0,1,0,1,1
2011-03-01 05:00:00,0,1,1,1,2
2011-03-01 06:00:00,0,1,0,46,46
2011-03-01 07:00:00,0,1,2,105,107
2011-03-01 08:00:00,0,1,10,204,214
2011-03-01 09:00:00,0,1,8,116,124
2011-03-01 10:00:00,0,1,13,55,68
2011-03-01 11:00:00,0,1,8,48,56
2011-03-01 12:00:00,0,1,6,80,86
2011-03-01 13:00:00,0,1,13,65,78
2011-03-01 14:00:00,0,1,18,61,79
2011-03-01 15:00:00,0,1,7,57,64
2011-03-01 16:00:00,0,1,10,92,102
2011-03-01 17:00:00,0,1,12,230,242
2011-03-01 18:00:00,0,1,10,214,224
2011-03-01 19:00:00,0,1,4,115,119
2011-03-01 20:00:00,0,1,2,86,88
2011-03-01 21:00:00,0,1,8,55,63
2011-03-01 22:00:00,0,1,3,44,47
2011-03-01 23:00:00,0,1,2,23,25
2011-03-02 00:00:00,0,1,3,5,8
2011-03-02 01:00:00,0,1,0,4,4
2011-03-02 02:00:00,0,1,0,2,2
2011-03-02 03:00:00,0,1,3,1,4
2011-03-02 04:00:00,0,1,1,0,1
2011-03-02 05:00:00,0,1,0,5,5
2011-03-02 06:00:00,0,1,1,39,40
2011-03-02 07:00:00,0,1,2,108,110
2011-03-02 08:00:00,0,1,13,243,256
2011-03-02 09:00:00,0,1,7,141,148
2011-03-02 10:00:00,0,1,11,65,76
2011-03-02 11:00:00,0,1,8,65,73
2011-03-02 12:00:00,0,1,20,62,82
2011-03-02 13:00:00,0,1,35,90,125
2011-03-02 14:00:00,0,1,21,75,96
2011-03-02 15:00:00,0,1,19,91,110
2011-03-02 16:00:00,0,1,27,112,139
2011-03-02 17:00:00,0,1,30,238,268
2011-03-02 18:00:00,0,1,8,193,201
2011-03-02 19:00:00,0,1,6,144,150
2011-03-02 20:00:00,0,1,9,86,95
2011-03-02 21:00:00,0,1,3,68,71
2011-03-02 22:00:00,0,1,4,44,48
2011-03-02 23:00:00,0,1,0,22,22
2011-03-03 00:00:00,0,1,3,10,13
2011-03-03 01:00:00,0,1,0,1,1
2011-03-03 02:00:00,0,1,1,2,3
2011-03-03 03:00:00,0,1,0,1,1
2011-03-03 04:00:00,0,1,0,1,1
2011-03-03 05:00:00,0,1,1,7,8
2011-03-03 06:00:00,0,1,1,34,35
2011-03-03 07:00:00,0,1,1,110,111
2011-03-03 08:00:00,0,1,4,216,220
2011-03-03 09:00:00,0,1,10,135,145
2011-03-03 10:00:00,0,1,7,49,56
2011-03-03 11:00:00,0,1,10,40,50
2011-03-03 12:00:00,0,1,7,65,72
2011-03-03 13:00:00,0,1,13,67,80
2011-03-03 14:00:00,0,1,18,60,78
2011-03-03 15:00:00,0,1,6,62,68
2011-03-03 16:00:00,0,1,6,65,71
2011-03-03 17:00:00,0,1,17,185,202
2011-03-03 18:00:00,0,1,6,161,167
2011-03-03 19:00:00,0,1,5,101,106
2011-03-03 20:00:00,0,1,1,69,70
2011-03-03 21:00:00,0,1,3,48,51
2011-03-03 22:00:00,0,1,3,50,53
2011-03-03 23:00:00,0,1,0,23,23
2011-03-04 00:00:00,0,1,0,12,12
2011-03-04 01:00:00,0,1,0,4,4
2011-03-04 02:00:00,0,1,0,2,2
2011-03-04 03:00:00,0,1,0,1,1
2011-03-04 04:00:00,0,1,1,0,1
2011-03-04 05:00:00,0,1,0,7,7
2011-03-04 06:00:00,0,1,1,28,29
2011-03-04 07:00:00,0,1,0,83,83
2011-03-04 08:00:00,0,1,6,222,228
2011-03-04 09:00:00,0,1,12,138,150
2011-03-04 10:00:00,0,1,10,56,66
2011-03-04 11:00:00,0,1,16,73,89
2011-03-04 12:00:00,0,1,10,87,97
2011-03-04 13:00:00,0,1,13,74,87
2011-03-04 14:00:00,0,1,30,65,95
2011-03-04 15:00:00,0,1,31,75,106
2011-03-04 16:00:00,0,1,17,101,118
2011-03-04 17:00:00,0,1,22,206,228
2011-03-04 18:00:00,0,1,15,172,187
2011-03-04 19:00:00,0,1,5,102,107
2011-03-04 20:00:00,0,1,9,78,87
2011-03-04 21:00:00,0,1,6,64,70
2011-03-04 22:00:00,0,1,4,40,44
2011-03-04 23:00:00,0,1,6,40,46
2011-03-05 00:00:00,0,0,4,15,19
2011-03-05 01:00:00,0,0,5,20,25
2011-03-05 02:00:00,0,0,5,15,20
2011-03-05 03:00:00,0,0,0,2,2
2011-03-05 04:00:00,0,0,0,1,1
2011-03-05 05:00:00,0,0,0,3,3
2011-03-05 06:00:00,0,0,1,3,4
2011-03-05 07:00:00,0,0,5,10,15
2011-03-05 08:00:00,0,0,11,34,45
2011-03-05 09:00:00,0,0,15,48,63
2011-03-05 10:00:00,0,0,34,69,103
2011-03-05 11:00:00,0,0,43,116,159
2011-03-05 12:00:00,0,0,46,121,167
2011-03-05 13:00:00,0,0,60,130,190
2011-03-05 14:00:00,0,0,80,118,198
2011-03-05 15:00:00,0,0,83,122,205
2011-03-05 16:00:00,0,0,74,130,204
2011-03-05 17:00:00,0,0,60,104,164
2011-03-05 18:00:00,0,0,37,115,152
2011-03-05 19:00:00,0,0,27,62,89
2011-03-05 20:00:00,0,0,12,58,70
2011-03-05 21:00:00,0,0,12,60,72
2011-03-05 22:00:00,0,0,16,47,63
2011-03-05 23:00:00,0,0,10,34,44
2011-03-06 00:00:00,0,0,11,41,52
2011-03-06 01:00:00,0,0,12,27,39
2011-03-06 02:00:00,0,0,5,27,32
2011-03-06 03:00:00,0,0,2,9,11
2011-03-06 04:00:00,0,0,0,3,3
2011-03-06 06:00:00,0,0,1,1,2
2011-03-06 07:00:00,0,0,0,5,5
2011-03-06 08:00:00,0,0,1,8,9
2011-03-06 09:00:00,0,0,4,18,22
2011-03-06 10:00:00,0,0,4,27,31
2011-03-06 11:00:00,0,0,18,44,62
2011-03-06 12:00:00,0,0,10,69,79
2011-03-06 13:00:00,0,0,22,83,105
2011-03-06 14:00:00,0,0,12,27,39
2011-03-06 15:00:00,0,0,3,4,7
2011-03-06 16:00:00,0,0,3,8,11
2011-03-06 17:00:00,0,0,2,23,25
2011-03-06 18:00:00,0,0,0,23,23
2011-03-06 19:00:00,0,0,0,11,11
2011-03-06 20:00:00,0,0,3,8,11
2011-03-06 21:00:00,0,0,1,6,7
2011-03-06 22:00:00,0,0,0,10,10
2011-03-06 23:00:00,0,0,0,9,9
2011-03-07 00:00:00,0,1,0,4,4
2011-03-07 01:00:00,0,1,0,2,2
2011-03-07 03:00:00,0,1,0,1,1
2011-03-07 04:00:00,0,1,1,0,1
2011-03-07 05:00:00,0,1,0,1,1
2011-03-07 06:00:00,0,1,3,31,34
2011-03-07 07:00:00,0,1,3,88,91
2011-03-07 08:00:00,0,1,11,200,211
2011-03-07 09:00:00,0,1,5,129,134
2011-03-07 10:00:00,0,1,15,43,58
2011-03-07 11:00:00,0,1,19,41,60
2011-03-07 12:00:00,0,1,28,68,96
2011-03-07 13:00:00,0,1,16,54,70
2011-03-07 14:00:00,0,1,21,56,77
2011-03-07 15:00:00,0,1,32,64,96
2011-03-07 16:00:00,0,1,26,96,122
2011-03-07 17:00:00,0,1,27,206,233
2011-03-07 18:00:00,0,1,19,214,233
2011-03-07 19:00:00,0,1,11,134,145
2011-03-07 20:00:00,0,1,5,87,92
2011-03-07 21:00:00,0,1,1,53,54
2011-03-07 22:00:00,0,1,1,34,35
2011-03-07 23:00:00,0,1,0,22,22
2011-03-08 00:00:00,0,1,1,9,10
2011-03-08 01:00:00,0,1,0,4,4
2011-03-08 02:00:00,0,1,1,0,1
2011-03-08 03:00:00,0,1,5,2,7
2011-03-08 04:00:00,0,1,0,2,2
2011-03-08 05:00:00,0,1,2,8,10
2011-03-08 06:00:00,0,1,3,42,45
2011-03-08 07:00:00,0,1,9,119,128
2011-03-08 08:00:00,0,1,10,247,257
2011-03-08 09:00:00,0,1,11,140,151
2011-03-08 10:00:00,0,1,25,46,71
2011-03-08 11:00:00,0,1,26,52,78
2011-03-08 12:00:00,0,1,29,70,99
2011-03-08 13:00:00,0,1,25,73,98
2011-03-08 14:00:00,0,1,16,56,72
2011-03-08 15:00:00,0,1,35,77,112
2011-03-08 16:00:00,0,1,26,82,108
2011-03-08 17:00:00,0,1,39,209,248
2011-03-08 18:00:00,0,1,21,214,235
2011-03-08 19:00:00,0,1,9,141,150
2011-03-08 20:00:00,0,1,2,74,76
2011-03-08 21:00:00,0,1,7,68,75
2011-03-08 22:00:00,0,1,11,44,55
2011-03-08 23:00:00,0,1,3,38,41
2011-03-09 00:00:00,0,1,0,9,9
2011-03-09 01:00:00,0,1,0,4,4
2011-03-09 02:00:00,0,1,1,1,2
2011-03-09 03:00:00,0,1,1,2,3
2011-03-09 04:00:00,0,1,0,2,2
2011-03-09 05:00:00,0,1,1,7,8
2011-03-09 06:00:00,0,1,5,44,49
2011-03-09 07:00:00,0,1,18,123,141
2011-03-09 08:00:00,0,1,11,238,249
2011-03-09 09:00:00,0,1,5,136,141
2011-03-09 10:00:00,0,1,8,49,57
2011-03-09 11:00:00,0,1,15,44,59
2011-03-09 12:00:00,0,1,14,84,98
2011-03-09 13:00:00,0,1,17,82,99
2011-03-09 14:00:00,0,1,10,61,71
2011-03-09 15:00:00,0,1,15,64,79
2011-03-09 16:00:00,0,1,10,102,112
2011-03-09 17:00:00,0,1,18,176,194
2011-03-09 18:00:00,0,1,12,176,188
2011-03-09 19:00:00,0,1,11,123,134
2011-03-09 20:00:00,0,1,4,87,91
2011-03-09 21:00:00,0,1,10,52,62
2011-03-09 22:00:00,0,1,4,17,21
2011-03-09 23:00:00,0,1,1,17,18
2011-03-10 00:00:00,0,1,3,0,3
2011-03-10 01:00:00,0,1,0,2,2
2011-03-10 02:00:00,0,1,0,1,1
2011-03-10 05:00:00,0,1,1,2,3
2011-03-10 06:00:00,0,1,0,12,12
2011-03-10 07:00:00,0,1,1,36,37
2011-03-10 08:00:00,0,1,1,43,44
2011-03-10 09:00:00,0,1,1,23,24
2011-03-10 10:00:00,0,1,0,17,17
2011-03-10 11:00:00,0,1,6,5,11
2011-03-10 12:00:00,0,1,4,30,34
2011-03-10 13:00:00,0,1,1,11,12
2011-03-10 14:00:00,0,1,0,12,12
2011-03-10 15:00:00,0,1,3,11,14
2011-03-10 16:00:00,0,1,1,20,21
2011-03-10 17:00:00,0,1,2,109,111
2011-03-10 18:00:00,0,1,2,80,82
2011-03-10 19:00:00,0,1,5,51,56
2011-03-10 20:00:00,0,1,9,29,38
2011-03-10 21:00:00,0,1,1,27,28
2011-03-10 22:00:00,0,1,4,30,34
2011-03-10 23:00:00,0,1,1,26,27
2011-03-11 00:00:00,0,1,0,6,6
2011-03-11 01:00:00,0,1,0,8,8
2011-03-11 02:00:00,0,1,2,3,5
2011-03-11 03:00:00,0,1,0,2,2
2011-03-11 05:00:00,0,1,1,6,7
2011-03-11 06:00:00,0,1,1,31,32
2011-03-11 07:00:00,0,1,10,104,114
2011-03-11 08:00:00,0,1,15,244,259
2011-03-11 09:00:00,0,1,13,143,156
2011-03-11 10:00:00,0,1,18,60,78
2011-03-11 11:00:00,0,1,14,67,81
2011-03-11 12:00:00,0,1,15,96,111
2011-03-11 13:00:00,0,1,15,92,107
2011-03-11 14:00:00,0,1,25,64,89
2011-03-11 15:00:00,0,1,21,64,85
2011-03-11 16:00:00,0,1,18,95,113
2011-03-11 17:00:00,0,1,23,200,223
2011-03-11 18:00:00,0,1,19,134,153
2011-03-11 19:00:00,0,1,7,111,118
2011-03-11 20:00:00,0,1,6,70,76
2011-03-11 21:00:00,0,1,10,43,53
2011-03-11 22:00:00,0,1,11,53,64
2011-03-11 23:00:00,0,1,3,34,37
2011-03-12 00:00:00,0,0,4,30,34
2011-03-12 01:00:00,0,0,3,15,18
2011-03-12 02:00:00,0,0,0,14,14
2011-03-12 03:00:00,0,0,1,6,7
2011-03-12 04:00:00,0,0,0,1,1
2011-03-12 05:00:00,0,0,0,2,2
2011-03-12 06:00:00,0,0,2,2,4
2011-03-12 07:00:00,0,0,4,19,23
2011-03-12 08:00:00,0,0,9,44,53
2011-03-12 09:00:00,0,0,25,76,101
2011-03-12 10:00:00,0,0,21,78,99
2011-03-12 11:00:00,0,0,36,83,119
2011-03-12 12:00:00,0,0,51,107,158
2011-03-12 13:00:00,0,0,62,95,157
2011-03-12 14:00:00,0,0,70,96,166
2011-03-12 15:00:00,0,0,81,101,182
2011-03-12 16:00:00,0,0,100,144,244
2011-03-12 17:00:00,0,0,99,114,213
2011-03-12 18:00:00,0,0,54,91,145
2011-03-12 19:00:00,0,0,26,86,112
2011-03-12 20:00:00,0,0,22,64,86
2011-03-12 21:00:00,0,0,36,46,82
2011-03-12 22:00:00,0,0,7,56,63
2011-03-12 23:00:00,0,0,11,38,49
2011-03-13 00:00:00,0,0,3,35,38
2011-03-13 01:00:00,0,0,10,23,33
2011-03-13 03:00:00,0,0,6,17,23
2011-03-13 04:00:00,0,0,4,9,13
2011-03-13 05:00:00,0,0,0,3,3
2011-03-13 06:00:00,0,0,0,2,2
2011-03-13 07:00:00,0,0,2,8,10
2011-03-13 08:00:00,0,0,11,23,34
2011-03-13 09:00:00,0,0,8,36,44
2011-03-13 10:00:00,0,0,36,86,122
2011-03-13 11:00:00,0,0,88,93,181
2011-03-13 12:00:00,0,0,74,120,194
2011-03-13 13:00:00,0,0,97,124,221
2011-03-13 14:00:00,0,0,144,106,250
2011-03-13 15:00:00,0,0,149,155,304
2011-03-13 16:00:00,0,0,124,132,256
2011-03-13 17:00:00,0,0,98,143,241
2011-03-13 18:00:00,0,0,55,92,147
2011-03-13 19:00:00,0,0,28,73,101
2011-03-13 20:00:00,0,0,23,54,77
2011-03-13 21:00:00,0,0,9,49,58
2011-03-13 22:00:00,0,0,8,29,37
2011-03-13 23:00:00,0,0,5,23,28
2011-03-14 00:00:00,0,1,4,7,11
2011-03-14 01:00:00,0,1,0,1,1
2011-03-14 02:00:00,0,1,0,1,1
2011-03-14 03:00:00,0,1,0,3,3
2011-03-14 05:00:00,0,1,0,8,8
2011-03-14 06:00:00,0,1,1,27,28
2011-03-14 07:00:00,0,1,4,84,88
2011-03-14 08:00:00,0,1,24,217,241
2011-03-14 09:00:00,0,1,13,127,140
2011-03-14 10:00:00,0,1,27,57,84
2011-03-14 11:00:00,0,1,26,45,71
2011-03-14 12:00:00,0,1,40,54,94
2011-03-14 13:00:00,0,1,24,51,75
2011-03-14 14:00:00,0,1,27,52,79
2011-03-14 15:00:00,0,1,24,77,101
2011-03-14 16:00:00,0,1,27,80,107
2011-03-14 17:00:00,0,1,42,229,271
2011-03-14 18:00:00,0,1,25,210,235
2011-03-14 19:00:00,0,1,17,133,150
2011-03-14 20:00:00,0,1,23,106,129
2011-03-14 21:00:00,0,1,5,58,63
2011-03-14 22:00:00,0,1,4,43,47
2011-03-14 23:00:00,0,1,2,17,19
2011-03-15 00:00:00,0,1,7,7,14
2011-03-15 01:00:00,0,1,4,6,10
2011-03-15 02:00:00,0,1,1,2,3
2011-03-15 04:00:00,0,1,1,1,2
2011-03-15 05:00:00,0,1,0,11,11
2011-03-15 06:00:00,0,1,3,32,35
2011-03-15 07:00:00,0,1,10,109,119
2011-03-15 08:00:00,0,1,23,259,282
2011-03-15 09:00:00,0,1,10,147,157
2011-03-15 10:00:00,0,1,22,56,78
2011-03-15 11:00:00,0,1,27,51,78
2011-03-15 12:00:00,0,1,32,70,102
2011-03-15 13:00:00,0,1,23,74,97
2011-03-15 14:00:00,0,1,14,74,88
2011-03-15 15:00:00,0,1,24,66,90
2011-03-15 16:00:00,0,1,21,93,114
2011-03-15 17:00:00,0,1,22,195,217
2011-03-15 18:00:00,0,1,18,207,225
2011-03-15 19:00:00,0,1,14,138,152
2011-03-15 20:00:00,0,1,9,79,88
2011-03-15 21:00:00,0,1,2,53,55
2011-03-15 22:00:00,0,1,1,20,21
2011-03-15 23:00:00,0,1,1,17,18
2011-03-16 00:00:00,0,1,0,8,8
2011-03-16 01:00:00,0,1,1,2,3
2011-03-16 03:00:00,0,1,1,2,3
2011-03-16 04:00:00,0,1,0,1,1
2011-03-16 05:00:00,0,1,0,3,3
2011-03-16 06:00:00,0,1,1,30,31
2011-03-16 07:00:00,0,1,10,101,111
2011-03-16 08:00:00,0,1,26,227,253
2011-03-16 09:00:00,0,1,10,144,154
2011-03-16 10:00:00,0,1,19,49,68
2011-03-16 11:00:00,0,1,13,62,75
2011-03-16 12:00:00,0,1,23,65,88
2011-03-16 13:00:00,0,1,18,81,99
2011-03-16 14:00:00,0,1,33,67,100
2011-03-16 15:00:00,0,1,22,79,101
2011-03-16 16:00:00,0,1,30,121,151
2011-03-16 17:00:00,0,1,37,216,253
2011-03-16 18:00:00,0,1,26,211,237
2011-03-16 19:00:00,0,1,18,150,168
2011-03-16 20:00:00,0,1,10,111,121
2011-03-16 21:00:00,0,1,3,75,78
2011-03-16 22:00:00,0,1,11,48,59
2011-03-16 23:00:00,0,1,9,18,27
2011-03-17 00:00:00,0,1,4,19,23
2011-03-17 01:00:00,0,1,1,11,12
2011-03-17 02:00:00,0,1,3,5,8
2011-03-17 03:00:00,0,1,1,1,2
2011-03-17 04:00:00,0,1,0,3,3
2011-03-17 05:00:00,0,1,0,13,13
2011-03-17 06:00:00,0,1,4,47,51
2011-03-17 07:00:00,0,1,12,128,140
2011-03-17 08:00:00,0,1,17,282,299
2011-03-17 09:00:00,0,1,23,162,185
2011-03-17 10:00:00,0,1,9,69,78
2011-03-17 11:00:00,0,1,20,66,86
2011-03-17 12:00:00,0,1,24,81,105
2011-03-17 13:00:00,0,1,26,85,111
2011-03-17 14:00:00,0,1,32,87,119
2011-03-17 15:00:00,0,1,30,95,125
2011-03-17 16:00:00,0,1,34,108,142
2011-03-17 17:00:00,0,1,48,265,313
2011-03-17 18:00:00,0,1,50,260,310
2011-03-17 19:00:00,0,1,18,189,207
2011-03-17 20:00:00,0,1,25,112,137
2011-03-17 21:00:00,0,1,19,119,138
2011-03-17 22:00:00,0,1,17,70,87
2011-03-17 23:00:00,0,1,7,43,50
2011-03-18 00:00:00,0,1,5,24,29
2011-03-18 01:00:00,0,1,4,12,16
2011-03-18 02:00:00,0,1,5,9,14
2011-03-18 03:00:00,0,1,1,4,5
2011-03-18 05:00:00,0,1,2,8,10
2011-03-18 06:00:00,0,1,1,35,36
2011-03-18 07:00:00,0,1,11,112,123
2011-03-18 08:00:00,0,1,24,256,280
2011-03-18 09:00:00,0,1,18,192,210
2011-03-18 10:00:00,0,1,43,74,117
2011-03-18 11:00:00,0,1,55,104,159
2011-03-18 12:00:00,0,1,72,123,195
2011-03-18 13:00:00,0,1,57,118,175
2011-03-18 14:00:00,0,1,71,103,174
2011-03-18 15:00:00,0,1,62,111,173
2011-03-18 16:00:00,0,1,67,137,204
2011-03-18 17:00:00,0,1,95,237,332
2011-03-18 18:00:00,0,1,84,247,331
2011-03-18 19:00:00,0,1,58,132,190
2011-03-18 20:00:00,0,1,46,103,149
2011-03-18 21:00:00,0,1,22,91,113
2011-03-18 22:00:00,0,1,55,63,118
2011-03-18 23:00:00,0,1,26,60,86
2011-03-19 00:00:00,0,0,26,50,76
2011-03-19 01:00:00,0,0,16,35,51
2011-03-19 02:00:00,0,0,5,20,25
2011-03-19 03:00:00,0,0,1,7,8
2011-03-19 04:00:00,0,0,1,2,3
2011-03-19 05:00:00,0,0,0,2,2
2011-03-19 06:00:00,0,0,0,10,10
2011-03-19 07:00:00,0,0,4,9,13
2011-03-19 08:00:00,0,0,11,37,48
2011-03-19 09:00:00,0,0,35,41,76
2011-03-19 10:00:00,0,0,55,85,140
2011-03-19 11:00:00,0,0,90,106,196
2011-03-19 12:00:00,0,0,126,141,267
2011-03-19 13:00:00,0,0,174,127,301
2011-03-19 14:00:00,0,0,168,144,312
2011-03-19 15:00:00,0,0,170,143,313
2011-03-19 16:00:00,0,0,175,129,304
2011-03-19 17:00:00,0,0,138,140,278
2011-03-19 18:00:00,0,0,92,125,217
2011-03-19 19:00:00,0,0,38,116,154
2011-03-19 20:00:00,0,0,39,69,108
2011-03-19 21:00:00,0,0,20,73,93
2011-03-19 22:00:00,0,0,27,45,72
2011-03-19 23:00:00,0,0,13,37,50
2011-04-01 00:00:00,0,1,0,6,6
2011-04-01 01:00:00,0,1,0,4,4
2011-04-01 02:00:00,0,1,0,7,7
2011-04-01 03:00:00,0,1,0,4,4
2011-04-01 04:00:00,0,1,0,3,3
2011-04-01 05:00:00,0,1,1,11,12
2011-04-01 06:00:00,0,1,2,26,28
2011-04-01 07:00:00,0,1,4,91,95
2011-04-01 08:00:00,0,1,8,198,206
2011-04-01 09:00:00,0,1,11,162,173
2011-04-01 10:00:00,0,1,12,63,75
2011-04-01 11:00:00,0,1,17,72,89
2011-04-01 12:00:00,0,1,15,80,95
2011-04-01 13:00:00,0,1,18,92,110
2011-04-01 14:00:00,0,1,26,61,87
2011-04-01 15:00:00,0,1,30,81,111
2011-04-01 16:00:00,0,1,42,125,167
2011-04-01 17:00:00,0,1,36,245,281
2011-04-01 18:00:00,0,1,36,205,241
2011-04-01 19:00:00,0,1,16,120,136
2011-04-01 20:00:00,0,1,2,75,77
2011-04-01 21:00:00,0,1,9,84,93
2011-04-01 22:00:00,0,1,10,64,74
2011-04-01 23:00:00,0,1,12,41,53
2011-04-02 00:00:00,0,0,3,29,32
2011-04-02 01:00:00,0,0,4,28,32
2011-04-02 02:00:00,0,0,1,20,21
2011-04-02 03:00:00,0,0,1,8,9
2011-04-02 04:00:00,0,0,0,5,5
2011-04-02 05:00:00,0,0,1,4,5
2011-04-02 06:00:00,0,0,5,7,12
2011-04-02 07:00:00,0,0,2,16,18
2011-04-02 08:00:00,0,0,10,45,55
2011-04-02 09:00:00,0,0,22,65,87
2011-04-02 10:00:00,0,0,41,113,154
2011-04-02 11:00:00,0,0,72,126,198
2011-04-02 12:00:00,0,0,84,100,184
2011-04-02 13:00:00,0,0,56,81,137
2011-04-02 14:00:00,0,0,97,93,190
2011-04-02 15:00:00,0,0,72,64,136
2011-04-02 16:00:00,0,0,111,85,196
2011-04-02 17:00:00,0,0,89,95,184
2011-04-02 18:00:00,0,0,69,110,179
2011-04-02 19:00:00,0,0,71,77,148
2011-04-02 20:00:00,0,0,29,56,85
2011-04-02 21:00:00,0,0,24,53,77
2011-04-02 22:00:00,0,0,14,41,55
2011-04-02 23:00:00,0,0,20,33,53
2011-04-03 00:00:00,0,0,8,31,39
2011-04-03 01:00:00,0,0,8,26,34
2011-04-03 02:00:00,0,0,5,19,24
2011-04-03 03:00:00,0,0,3,8,11
2011-04-03 04:00:00,0,0,3,0,3
2011-04-03 05:00:00,0,0,1,4,5
2011-04-03 06:00:00,0,0,10,23,33
2011-04-03 07:00:00,0,0,13,20,33
2011-04-03 08:00:00,0,0,18,44,62
2011-04-03 09:00:00,0,0,68,74,142
2011-04-03 10:00:00,0,0,111,104,215
2011-04-03 11:00:00,0,0,139,104,243
2011-04-03 12:00:00,0,0,166,147,313
2011-04-03 13:00:00,0,0,219,148,367
2011-04-03 14:00:00,0,0,240,109,349
2011-04-03 15:00:00,0,0,174,118,292
2011-04-03 16:00:00,0,0,147,156,303
2011-04-03 17:00:00,0,0,148,126,274
2011-04-03 18:00:00,0,0,71,101,172
2011-04-03 19:00:00,0,0,51,93,144
2011-04-03 20:00:00,0,0,24,55,79
2011-04-03 21:00:00,0,0,8,37,45
2011-04-03 22:00:00,0,0,7,29,36
2011-04-03 23:00:00,0,0,9,22,31
2011-04-04 00:00:00,0,1,1,5,6
2011-04-04 01:00:00,0,1,7,4,11
2011-04-04 02:00:00,0,1,1,1,2
2011-04-04 03:00:00,0,1,1,0,1
2011-04-04 04:00:00,0,1,1,1,2
2011-04-04 05:00:00,0,1,0,7,7
2011-04-04 06:00:00,0,1,3,43,46
2011-04-04 07:00:00,0,1,7,150,157
2011-04-04 08:00:00,0,1,31,308,339
2011-04-04 09:00:00,0,1,24,134,158
2011-04-04 10:00:00,0,1,35,55,90
2011-04-04 11:00:00,0,1,58,66,124
2011-04-04 12:00:00,0,1,59,98,157
2011-04-04 13:00:00,0,1,47,92,139
2011-04-04 14:00:00,0,1,47,76,123
2011-04-04 15:00:00,0,1,47,96,143
2011-04-04 16:00:00,0,1,59,130,189
2011-04-04 17:00:00,0,1,83,283,366
2011-04-04 18:00:00,0,1,78,308,386
2011-04-04 19:00:00,0,1,51,227,278
2011-04-04 20:00:00,0,1,40,133,173
2011-04-04 21:00:00,0,1,19,76,95
2011-04-04 22:00:00,0,1,17,58,75
2011-04-04 23:00:00,0,1,18,30,48
2011-04-05 00:00:00,0,1,10,12,22
2011-04-05 01:00:00,0,1,10,5,15
2011-04-05 02:00:00,0,1,0,5,5
2011-04-05 03:00:00,0,1,1,3,4
2011-04-05 04:00:00,0,1,0,2,2
2011-04-05 05:00:00,0,1,0,5,5
2011-04-05 06:00:00,0,1,2,36,38
2011-04-05 07:00:00,0,1,10,124,134
2011-04-05 08:00:00,0,1,9,148,157
2011-04-05 09:00:00,0,1,2,44,46
2011-04-05 10:00:00,0,1,3,25,28
2011-04-05 11:00:00,0,1,1,18,19
2011-04-05 12:00:00,0,1,6,32,38
2011-04-05 13:00:00,0,1,5,51,56
2011-04-05 14:00:00,0,1,9,67,76
2011-04-05 15:00:00,0,1,6,62,68
2011-04-05 16:00:00,0,1,17,113,130
2011-04-05 17:00:00,0,1,27,246,273
2011-04-05 18:00:00,0,1,19,248,267
2011-04-05 19:00:00,0,1,12,148,160
2011-04-05 20:00:00,0,1,4,87,91
2011-04-05 21:00:00,0,1,8,81,89
2011-04-05 22:00:00,0,1,3,43,46
2011-04-05 23:00:00,0,1,3,23,26
2011-04-06 00:00:00,0,1,0,15,15
2011-04-06 01:00:00,0,1,0,2,2
2011-04-06 02:00:00,0,1,0,5,5
2011-04-06 03:00:00,0,1,0,4,4
2011-04-06 04:00:00,0,1,0,1,1
2011-04-06 05:00:00,0,1,1,12,13
2011-04-06 06:00:00,0,1,4,52,56
2011-04-06 07:00:00,0,1,3,130,133
2011-04-06 08:00:00,0,1,17,308,325
2011-04-06 09:00:00,0,1,8,157,165
2011-04-06 10:00:00,0,1,21,48,69
2011-04-06 11:00:00,0,1,23,70,93
2011-04-06 12:00:00,0,1,22,112,134
2011-04-06 13:00:00,0,1,29,83,112
2011-04-06 14:00:00,0,1,35,80,115
2011-04-06 15:00:00,0,1,34,83,117
2011-04-06 16:00:00,0,1,27,142,169
2011-04-06 17:00:00,0,1,53,303,356
2011-04-06 18:00:00,0,1,43,282,325
2011-04-06 19:00:00,0,1,36,196,232
2011-04-06 20:00:00,0,1,15,126,141
2011-04-06 21:00:00,0,1,18,84,102
2011-04-06 22:00:00,0,1,13,71,84
2011-04-06 23:00:00,0,1,11,29,40
2011-04-07 00:00:00,0,1,5,15,20
2011-04-07 01:00:00,0,1,2,11,13
2011-04-07 02:00:00,0,1,0,7,7
2011-04-07 03:00:00,0,1,0,3,3
2011-04-07 04:00:00,0,1,0,1,1
2011-04-07 05:00:00,0,1,0,6,6
2011-04-07 06:00:00,0,1,5,59,64
2011-04-07 07:00:00,0,1,8,152,160
2011-04-07 08:00:00,0,1,23,291,314
2011-04-07 09:00:00,0,1,15,155,170
2011-04-07 10:00:00,0,1,29,66,95
2011-04-07 11:00:00,0,1,36,86,122
2011-04-07 12:00:00,0,1,39,114,153
2011-04-07 13:00:00,0,1,36,99,135
2011-04-07 14:00:00,0,1,46,111,157
2011-04-07 15:00:00,0,1,27,133,160
2011-04-07 16:00:00,0,1,52,161,213
2011-04-07 17:00:00,0,1,63,280,343
2011-04-07 18:00:00,0,1,68,265,333
2011-04-07 19:00:00,0,1,34,192,226
2011-04-07 20:00:00,0,1,37,166,203
2011-04-07 21:00:00,0,1,19,89,108
2011-04-07 22:00:00,0,1,18,63,81
2011-04-07 23:00:00,0,1,9,45,54
2011-04-08 00:00:00,0,1,4,21,25
2011-04-08 01:00:00,0,1,3,6,9
2011-04-08 02:00:00,0,1,3,10,13
2011-04-08 03:00:00,0,1,0,1,1
2011-04-08 04:00:00,0,1,0,1,1
2011-04-08 05:00:00,0,1,1,8,9
2011-04-08 06:00:00,0,1,2,33,35
2011-04-08 07:00:00,0,1,4,109,113
2011-04-08 08:00:00,0,1,13,208,221
2011-04-08 09:00:00,0,1,17,168,185
2011-04-08 10:00:00,0,1,10,63,73
2011-04-08 11:00:00,0,1,19,79,98
2011-04-08 12:00:00,0,1,29,51,80
2011-04-08 13:00:00,0,1,7,35,42
2011-04-08 14:00:00,0,1,2,13,15
2011-04-08 15:00:00,0,1,1,24,25
2011-04-08 16:00:00,0,1,2,58,60
2011-04-08 17:00:00,0,1,10,138,148
2011-04-08 18:00:00,0,1,8,54,62
2011-04-08 19:00:00,0,1,1,52,53
2011-04-08 20:00:00,0,1,12,51,63
2011-04-08 21:00:00,0,1,11,43,54
2011-04-08 22:00:00,0,1,9,42,51
2011-04-08 23:00:00,0,1,4,31,35
2011-04-09 00:00:00,0,0,5,26,31
2011-04-09 01:00:00,0,0,3,17,20
2011-04-09 02:00:00,0,0,2,15,17
2011-04-09 03:00:00,0,0,3,11,14
2011-04-09 04:00:00,0,0,0,3,3
2011-04-09 05:00:00,0,0,0,5,5
2011-04-09 06:00:00,0,0,0,13,13
2011-04-09 07:00:00,0,0,8,13,21
2011-04-09 08:00:00,0,0,7,47,54
2011-04-09 09:00:00,0,0,27,71,98
2011-04-09 10:00:00,0,0,43,90,133
2011-04-09 11:00:00,0,0,51,91,142
2011-04-09 12:00:00,0,0,79,123,202
2011-04-09 13:00:00,0,0,114,108,222
2011-04-09 14:00:00,0,0,94,118,212
2011-04-09 15:00:00,0,0,85,116,201
2011-04-09 16:00:00,0,0,73,118,191
2011-04-09 17:00:00,0,0,128,129,257
2011-04-09 18:00:00,0,0,48,129,177
2011-04-09 19:00:00,0,0,47,83,130
2011-04-09 20:00:00,0,0,19,74,93
2011-04-09 21:00:00,0,0,10,65,75
2011-04-09 22:00:00,0,0,21,66,87
2011-04-09 23:00:00,0,0,12,45,57
2011-04-10 00:00:00,0,0,5,48,53
2011-04-10 01:00:00,0,0,6,31,37
2011-04-10 02:00:00,0,0,12,24,36
2011-04-10 03:00:00,0,0,5,11,16
2011-04-10 04:00:00,0,0,3,2,5
2011-04-10 05:00:00,0,0,0,4,4
2011-04-10 06:00:00,0,0,0,4,4
2011-04-10 07:00:00,0,0,3,7,10
2011-04-10 08:00:00,0,0,17,38,55
2011-04-10 09:00:00,0,0,31,50,81
2011-04-10 10:00:00,0,0,69,81,150
2011-04-10 11:00:00,0,0,93,109,202
2011-04-10 12:00:00,0,0,94,136,230
2011-04-10 13:00:00,0,0,121,142,263
2011-04-10 14:00:00,0,0,148,133,281
2011-04-10 15:00:00,0,0,156,141,297
2011-04-10 16:00:00,0,0,135,153,288
2011-04-10 17:00:00,0,0,84,152,236
2011-04-10 18:00:00,0,0,103,137,240
2011-04-10 19:00:00,0,0,47,84,131
2011-04-10 20:00:00,0,0,21,71,92
2011-04-10 21:00:00,0,0,18,77,95
2011-04-10 22:00:00,0,0,12,45,57
2011-04-10 23:00:00,0,0,5,27,32
2011-04-11 00:00:00,0,1,7,16,23
2011-04-11 01:00:00,0,1,1,3,4
2011-04-11 02:00:00,0,1,7,2,9
2011-04-11 04:00:00,0,1,0,1,1
2011-04-11 05:00:00,0,1,1,12,13
2011-04-11 06:00:00,0,1,2,59,61
2011-04-11 07:00:00,0,1,12,164,176
2011-04-11 08:00:00,0,1,28,286,314
2011-04-11 09:00:00,0,1,33,132,165
2011-04-11 10:00:00,0,1,41,55,96
2011-04-11 11:00:00,0,1,45,59,104
2011-04-11 12:00:00,0,1,37,97,134
2011-04-11 13:00:00,0,1,62,77,139
2011-04-11 14:00:00,0,1,60,85,145
2011-04-11 15:00:00,0,1,56,85,141
2011-04-11 16:00:00,0,1,73,162,235
2011-04-11 17:00:00,0,1,100,352,452
2011-04-11 18:00:00,0,1,93,290,383
2011-04-11 19:00:00,0,1,73,211,284
2011-04-11 20:00:00,0,1,44,122,166
2011-04-11 21:00:00,0,1,39,119,158
2011-04-11 22:00:00,0,1,25,66,91
2011-04-11 23:00:00,0,1,16,38,54
2011-04-12 00:00:00,0,1,11,13,24
2011-04-12 01:00:00,0,1,6,7,13
2011-04-12 02:00:00,0,1,7,7,14
2011-04-12 03:00:00,0,1,0,1,1
2011-04-12 04:00:00,0,1,4,2,6
2011-04-12 05:00:00,0,1,1,15,16
2011-04-12 06:00:00,0,1,3,55,58
2011-04-12 07:00:00,0,1,12,177,189
2011-04-12 08:00:00,0,1,15,211,226
2011-04-12 09:00:00,0,1,4,50,54
2011-04-12 10:00:00,0,1,6,34,40
2011-04-12 11:00:00,0,1,11,38,49
2011-04-12 12:00:00,0,1,9,83,92
2011-04-12 13:00:00,0,1,22,84,106
2011-04-12 14:00:00,0,1,16,28,44
2011-04-12 15:00:00,0,1,24,54,78
2011-04-12 16:00:00,0,1,19,80,99
2011-04-12 17:00:00,0,1,29,262,291
2011-04-12 18:00:00,0,1,21,203,224
2011-04-12 19:00:00,0,1,3,127,130
2011-04-12 20:00:00,0,1,9,94,103
2011-04-12 21:00:00,0,1,10,74,84
2011-04-12 22:00:00,0,1,7,47,54
2011-04-12 23:00:00,0,1,8,31,39
2011-04-13 00:00:00,0,1,3,12,15
2011-04-13 01:00:00,0,1,0,1,1
2011-04-13 02:00:00,0,1,0,2,2
2011-04-13 03:00:00,0,1,0,2,2
2011-04-13 04:00:00,0,1,1,2,3
2011-04-13 05:00:00,0,1,1,4,5
2011-04-13 06:00:00,0,1,1,33,34
2011-04-13 07:00:00,0,1,3,67,70
2011-04-13 08:00:00,0,1,6,158,164
2011-04-13 09:00:00,0,1,2,63,65
2011-04-13 10:00:00,0,1,4,42,46
2011-04-13 11:00:00,0,1,4,57,61
2011-04-13 12:00:00,0,1,12,83,95
2011-04-13 13:00:00,0,1,6,55,61
2011-04-13 14:00:00,0,1,24,82,106
2011-04-13 15:00:00,0,1,12,69,81
2011-04-13 16:00:00,0,1,23,119,142
2011-04-13 17:00:00,0,1,25,284,309
2011-04-13 18:00:00,0,1,28,293,321
2011-04-13 19:00:00,0,1,15,160,175
2011-04-13 20:00:00,0,1,7,119,126
2011-04-13 21:00:00,0,1,17,100,117
2011-04-13 22:00:00,0,1,10,89,99
2011-04-13 23:00:00,0,1,5,57,62
2011-04-14 00:00:00,0,1,3,18,21
2011-04-14 01:00:00,0,1,1,9,10
2011-04-14 02:00:00,0,1,0,3,3
2011-04-14 03:00:00,0,1,0,2,2
2011-04-14 04:00:00,0,1,1,8,9
2011-04-14 05:00:00,0,1,2,12,14
2011-04-14 06:00:00,0,1,4,66,70
2011-04-14 07:00:00,0,1,11,182,193
2011-04-14 08:00:00,0,1,21,316,337
2011-04-14 09:00:00,0,1,18,152,170
2011-04-14 10:00:00,0,1,21,68,89
2011-04-14 11:00:00,0,1,28,87,115
2011-04-14 12:00:00,0,1,35,110,145
2011-04-14 13:00:00,0,1,38,121,159
2011-04-14 14:00:00,0,1,36,101,137
2011-04-14 15:00:00,0,1,57,85,142
2011-04-14 16:00:00,0,1,49,153,202
2011-04-14 17:00:00,0,1,50,338,388
2011-04-14 18:00:00,0,1,47,290,337
2011-04-14 19:00:00,0,1,37,222,259
2011-04-14 20:00:00,0,1,22,147,169
2011-04-14 21:00:00,0,1,19,126,145
2011-04-14 22:00:00,0,1,22,82,104
2011-04-14 23:00:00,0,1,7,40,47
2011-04-15 00:00:00,1,0,6,21,27
2011-04-15 01:00:00,1,0,6,9,15
2011-04-15 02:00:00,1,0,8,10,18
2011-04-15 03:00:00,1,0,0,3,3
2011-04-15 04:00:00,1,0,0,3,3
2011-04-15 05:00:00,1,0,2,11,13
2011-04-15 06:00:00,1,0,5,42,47
2011-04-15 07:00:00,1,0,10,139,149
2011-04-15 08:00:00,1,0,21,279,300
2011-04-15 09:00:00,1,0,16,162,178
2011-04-15 10:00:00,1,0,31,91,122
2011-04-15 11:00:00,1,0,41,95,136
2011-04-15 12:00:00,1,0,45,155,200
2011-04-15 13:00:00,1,0,47,133,180
2011-04-15 14:00:00,1,0,57,106,163
2011-04-15 15:00:00,1,0,50,112,162
2011-04-15 16:00:00,1,0,70,173,243
2011-04-15 17:00:00,1,0,64,267,331
2011-04-15 18:00:00,1,0,47,216,263
2011-04-15 19:00:00,1,0,41,168,209
2011-04-15 20:00:00,1,0,26,92,118
2011-04-15 21:00:00,1,0,25,77,102
2011-04-15 22:00:00,1,0,16,64,80
2011-04-15 23:00:00,1,0,8,56,64
2011-04-16 00:00:00,0,0,7,36,43
2011-04-16 01:00:00,0,0,5,28,33
2011-04-16 02:00:00,0,0,5,19,24
2011-04-16 03:00:00,0,0,5,9,14
2011-04-16 04:00:00,0,0,1,4,5
2011-04-16 05:00:00,0,0,1,3,4
2011-04-16 06:00:00,0,0,1,9,10
2011-04-16 07:00:00,0,0,3,18,21
2011-04-16 08:00:00,0,0,7,38,45
2011-04-16 09:00:00,0,0,2,27,29
2011-04-16 10:00:00,0,0,1,21,22
2011-04-16 11:00:00,0,0,4,27,31
2011-04-16 12:00:00,0,0,6,26,32
2011-04-16 13:00:00,0,0,9,49,58
2011-04-16 14:00:00,0,0,14,49,63
2011-04-16 15:00:00,0,0,16,62,78
2011-04-16 16:00:00,0,0,6,27,33
2011-04-16 17:00:00,0,0,1,14,15
2011-04-16 18:00:00,0,0,6,32,38
2011-04-16 19:00:00,0,0,9,62,71
2011-04-16 20:00:00,0,0,4,49,53
2011-04-16 21:00:00,0,0,1,13,14
2011-04-16 22:00:00,0,0,2,22,24
2011-04-16 23:00:00,0,0,5,30,35
2011-04-17 00:00:00,0,0,4,29,33
2011-04-17 01:00:00,0,0,6,25,31
2011-04-17 02:00:00,0,0,4,25,29
2011-04-17 03:00:00,0,0,12,13,25
2011-04-17 04:00:00,0,0,2,5,7
2011-04-17 05:00:00,0,0,2,1,3
2011-04-17 06:00:00,0,0,3,5,8
2011-04-17 07:00:00,0,0,2,14,16
2011-04-17 08:00:00,0,0,7,36,43
2011-04-17 09:00:00,0,0,31,71,102
2011-04-17 10:00:00,0,0,91,120,211
2011-04-17 11:00:00,0,0,119,185,304
2011-04-17 12:00:00,0,0,167,187,354
2011-04-17 13:00:00,0,0,181,162,343
2011-04-17 14:00:00,0,0,170,191,361
2011-04-17 15:00:00,0,0,179,209,388
2011-04-17 16:00:00,0,0,161,182,343
2011-04-17 17:00:00,0,0,143,163,306
2011-04-17 18:00:00,0,0,102,175,277
2011-04-17 19:00:00,0,0,75,135,210
2011-04-17 20:00:00,0,0,44,97,141
2011-04-17 21:00:00,0,0,13,70,83
2011-04-17 22:00:00,0,0,21,49,70
2011-04-17 23:00:00,0,0,19,37,56
2011-04-18 00:00:00,0,1,15,24,39
2011-04-18 01:00:00,0,1,11,8,19
2011-04-18 02:00:00,0,1,14,2,16
2011-04-18 03:00:00,0,1,6,1,7
2011-04-18 04:00:00,0,1,2,4,6
2011-04-18 05:00:00,0,1,0,16,16
2011-04-18 06:00:00,0,1,3,51,54
2011-04-18 07:00:00,0,1,12,156,168
2011-04-18 08:00:00,0,1,20,277,297
2011-04-18 09:00:00,0,1,37,132,169
2011-04-18 10:00:00,0,1,41,68,109
2011-04-18 11:00:00,0,1,36,87,123
2011-04-18 12:00:00,0,1,60,124,184
2011-04-18 13:00:00,0,1,41,128,169
2011-04-18 14:00:00,0,1,49,95,144
2011-04-18 15:00:00,0,1,64,112,176
2011-04-18 16:00:00,0,1,40,165,205
2011-04-18 17:00:00,0,1,66,362,428
2011-04-18 18:00:00,0,1,41,321,362
2011-04-18 19:00:00,0,1,42,244,286
2011-04-18 20:00:00,0,1,29,136,165
2011-04-18 21:00:00,0,1,20,131,151
2011-04-18 22:00:00,0,1,9,81,90
2011-04-18 23:00:00,0,1,11,35,46
2011-04-19 00:00:00,0,1,2,23,25
2011-04-19 01:00:00,0,1,5,2,7
2011-04-19 02:00:00,0,1,8,5,13
2011-04-19 03:00:00,0,1,0,3,3
2011-04-19 04:00:00,0,1,1,4,5
2011-04-19 05:00:00,0,1,1,17,18
2011-04-19 06:00:00,0,1,2,63,65
2011-04-19 07:00:00,0,1,22,166,188
2011-04-19 08:00:00,0,1,20,331,351
2011-04-19 09:00:00,0,1,23,139,162
2011-04-19 10:00:00,0,1,15,60,75
2011-04-19 11:00:00,0,1,19,53,72
2011-04-19 12:00:00,0,1,19,84,103
2011-04-19 13:00:00,0,1,26,103,129
2011-04-19 14:00:00,0,1,19,88,107
2011-04-19 15:00:00,0,1,44,83,127
2011-04-19 16:00:00,0,1,30,162,192
2011-04-19 17:00:00,0,1,39,372,411
2011-04-19 18:00:00,0,1,44,377,421
2011-04-19 19:00:00,0,1,28,248,276
2011-04-19 20:00:00,0,1,20,148,168
2011-04-19 21:00:00,0,1,8,114,122
2011-04-19 22:00:00,0,1,3,109,112
2011-04-19 23:00:00,0,1,11,41,52
2011-05-01 00:00:00,0,0,19,77,96
2011-05-01 01:00:00,0,0,9,50,59
2011-05-01 02:00:00,0,0,7,43,50
2011-05-01 03:00:00,0,0,8,15,23
2011-05-01 04:00:00,0,0,6,11,17
2011-05-01 05:00:00,0,0,0,10,10
2011-05-01 06:00:00,0,0,4,9,13
2011-05-01 07:00:00,0,0,7,26,33
2011-05-01 08:00:00,0,0,16,43,59
2011-05-01 09:00:00,0,0,45,96,141
2011-05-01 10:00:00,0,0,109,155,264
2011-05-01 11:00:00,0,0,109,141,250
2011-05-01 12:00:00,0,0,109,172,281
2011-05-01 13:00:00,0,0,123,209,332
2011-05-01 14:00:00,0,0,85,153,238
2011-05-01 15:00:00,0,0,113,153,266
2011-05-01 16:00:00,0,0,75,139,214
2011-05-01 17:00:00,0,0,60,136,196
2011-05-01 18:00:00,0,0,33,126,159
2011-05-01 19:00:00,0,0,47,131,178
2011-05-01 20:00:00,0,0,35,86,121
2011-05-01 21:00:00,0,0,23,82,105
2011-05-01 22:00:00,0,0,32,68,100
2011-05-01 23:00:00,0,0,64,82,146
2011-05-02 00:00:00,0,1,68,109,177
2011-05-02 01:00:00,0,1,41,73,114
2011-05-02 02:00:00,0,1,16,19,35
2011-05-02 03:00:00,0,1,9,7,16
2011-05-02 04:00:00,0,1,9,8,17
2011-05-02 05:00:00,0,1,4,16,20
2011-05-02 06:00:00,0,1,3,59,62
2011-05-02 07:00:00,0,1,16,193,209
2011-05-02 08:00:00,0,1,21,350,371
2011-05-02 09:00:00,0,1,41,131,172
2011-05-02 10:00:00,0,1,31,77,108
2011-05-02 11:00:00,0,1,34,96,130
2011-05-02 12:00:00,0,1,40,147,187
2011-05-02 13:00:00,0,1,51,119,170
2011-05-02 14:00:00,0,1,48,133,181
2011-05-02 15:00:00,0,1,45,110,155
2011-05-02 16:00:00,0,1,49,220,269
2011-05-02 17:00:00,0,1,65,472,537
2011-05-02 18:00:00,0,1,68,450,518
2011-05-02 19:00:00,0,1,46,268,314
2011-05-02 20:00:00,0,1,44,174,218
2011-05-02 21:00:00,0,1,54,178,232
2011-05-02 22:00:00,0,1,28,97,125
2011-05-02 23:00:00,0,1,16,48,64
2011-05-03 00:00:00,0,1,0,16,16
2011-05-03 01:00:00,0,1,0,14,14
2011-05-03 02:00:00,0,1,0,5,5
2011-05-03 03:00:00,0,1,0,2,2
2011-05-03 04:00:00,0,1,3,1,4
2011-05-03 05:00:00,0,1,0,14,14
2011-05-03 06:00:00,0,1,7,102,109
2011-05-03 07:00:00,0,1,17,248,265
2011-05-03 08:00:00,0,1,24,435,459
2011-05-03 09:00:00,0,1,29,157,186
2011-05-03 10:00:00,0,1,36,91,127
2011-05-03 11:00:00,0,1,20,120,140
2011-05-03 12:00:00,0,1,48,169,217
2011-05-03 13:00:00,0,1,50,144,194
2011-05-03 14:00:00,0,1,36,122,158
2011-05-03 15:00:00,0,1,37,117,154
2011-05-03 16:00:00,0,1,46,225,271
2011-05-03 17:00:00,0,1,53,464,517
2011-05-03 18:00:00,0,1,59,485,544
2011-05-03 19:00:00,0,1,42,323,365
2011-05-03 20:00:00,0,1,28,262,290
2011-05-03 21:00:00,0,1,42,183,225
2011-05-03 22:00:00,0,1,14,99,113
2011-05-03 23:00:00,0,1,12,50,62
2011-05-04 00:00:00,0,1,5,22,27
2011-05-04 01:00:00,0,1,1,6,7
2011-05-04 02:00:00,0,1,0,4,4
2011-05-04 03:00:00,0,1,0,1,1
2011-05-04 04:00:00,0,1,1,2,3
2011-05-04 05:00:00,0,1,1,8,9
2011-05-04 06:00:00,0,1,0,21,21
2011-05-04 07:00:00,0,1,6,46,52
2011-05-04 08:00:00,0,1,5,74,79
2011-05-04 09:00:00,0,1,5,35,40
2011-05-04 10:00:00,0,1,5,26,31
2011-05-04 11:00:00,0,1,3,69,72
2011-05-04 12:00:00,0,1,19,105,124
2011-05-04 13:00:00,0,1,15,128,143
2011-05-04 14:00:00,0,1,13,94,107
2011-05-04 15:00:00,0,1,22,107,129
2011-05-04 16:00:00,0,1,22,173,195
2011-05-04 17:00:00,0,1,22,388,410
2011-05-04 18:00:00,0,1,29,367,396
2011-05-04 19:00:00,0,1,30,266,296
2011-05-04 20:00:00,0,1,17,174,191
2011-05-04 21:00:00,0,1,17,133,150
2011-05-04 22:00:00,0,1,9,80,89
2011-05-04 23:00:00,0,1,8,49,57
2011-05-05 00:00:00,0,1,4,23,27
2011-05-05 01:00:00,0,1,4,6,10
2011-05-05 02:00:00,0,1,1,4,5
2011-05-05 03:00:00,0,1,0,4,4
2011-05-05 04:00:00,0,1,4,3,7
2011-05-05 05:00:00,0,1,1,29,30
2011-05-05 06:00:00,0,1,3,86,89
2011-05-05 07:00:00,0,1,16,255,271
2011-05-05 08:00:00,0,1,25,415,440
2011-05-05 09:00:00,0,1,20,164,184
2011-05-05 10:00:00,0,1,30,98,128
2011-05-05 11:00:00,0,1,43,105,148
2011-05-05 12:00:00,0,1,27,169,196
2011-05-05 13:00:00,0,1,50,142,192
2011-05-05 14:00:00,0,1,19,135,154
2011-05-05 15:00:00,0,1,27,120,147
2011-05-05 16:00:00,0,1,36,233,269
2011-05-05 17:00:00,0,1,66,467,533
2011-05-05 18:00:00,0,1,64,456,520
2011-05-05 19:00:00,0,1,56,305,361
2011-05-05 20:00:00,0,1,33,225,258
2011-05-05 21:00:00,0,1,39,141,180
2011-05-05 22:00:00,0,1,30,135,165
2011-05-05 23:00:00,0,1,16,99,115
2011-05-06 00:00:00,0,1,13,43,56
2011-05-06 01:00:00,0,1,8,24,32
2011-05-06 02:00:00,0,1,1,15,16
2011-05-06 03:00:00,0,1,3,6,9
2011-05-06 04:00:00,0,1,0,1,1
2011-05-06 05:00:00,0,1,0,16,16
2011-05-06 06:00:00,0,1,8,74,82
2011-05-06 07:00:00,0,1,20,202,222
2011-05-06 08:00:00,0,1,35,415,450
2011-05-06 09:00:00,0,1,27,161,188
2011-05-06 10:00:00,0,1,30,97,127
2011-05-06 11:00:00,0,1,42,123,165
2011-05-06 12:00:00,0,1,48,198,246
2011-05-06 13:00:00,0,1,71,182,253
2011-05-06 14:00:00,0,1,86,127,213
2011-05-06 15:00:00,0,1,89,171,260
2011-05-06 16:00:00,0,1,82,262,344
2011-05-06 17:00:00,0,1,83,470,553
2011-05-06 18:00:00,0,1,85,385,470
2011-05-06 19:00:00,0,1,39,253,292
2011-05-06 20:00:00,0,1,29,161,190
2011-05-06 21:00:00,0,1,22,130,152
2011-05-06 22:00:00,0,1,46,105,151
2011-05-06 23:00:00,0,1,27,93,120
2011-05-07 00:00:00,0,0,10,76,86
2011-05-07 01:00:00,0,0,8,50,58
2011-05-07 02:00:00,0,0,5,47,52
2011-05-07 03:00:00,0,0,9,9,18
2011-05-07 04:00:00,0,0,1,4,5
2011-05-07 05:00:00,0,0,4,3,7
2011-05-07 06:00:00,0,0,1,12,13
2011-05-07 07:00:00,0,0,8,32,40
2011-05-07 08:00:00,0,0,19,96,115
2011-05-07 09:00:00,0,0,54,164,218
2011-05-07 10:00:00,0,0,90,208,298
2011-05-07 11:00:00,0,0,132,215,347
2011-05-07 12:00:00,0,0,129,244,373
2011-05-07 13:00:00,0,0,196,240,436
2011-05-07 14:00:00,0,0,143,235,378
2011-05-07 15:00:00,0,0,148,230,378
2011-05-07 16:00:00,0,0,119,223,342
2011-05-07 17:00:00,0,0,138,216,354
2011-05-07 18:00:00,0,0,114,175,289
2011-05-07 19:00:00,0,0,88,179,267
2011-05-07 20:00:00,0,0,82,137,219
2011-05-07 21:00:00,0,0,58,124,182
2011-05-07 22:00:00,0,0,26,94,120
2011-05-07 23:00:00,0,0,30,89,119
2011-05-08 00:00:00,0,0,22,78,100
2011-05-08 01:00:00,0,0,8,56,64
2011-05-08 02:00:00,0,0,17,42,59
2011-05-08 03:00:00,0,0,10,21,31
2011-05-08 04:00:00,0,0,2,8,10
2011-05-08 05:00:00,0,0,0,5,5
2011-05-08 06:00:00,0,0,2,4,6
2011-05-08 07:00:00,0,0,8,15,23
2011-05-08 08:00:00,0,0,28,58,86
2011-05-08 09:00:00,0,0,48,112,160
2011-05-08 10:00:00,0,0,91,153,244
2011-05-08 11:00:00,0,0,142,198,340
2011-05-08 12:00:00,0,0,139,243,382
2011-05-08 13:00:00,0,0,166,224,390
2011-05-08 14:00:00,0,0,126,240,366
2011-05-08 15:00:00,0,0,128,230,358
2011-05-08 16:00:00,0,0,122,263,385
2011-05-08 17:00:00,0,0,106,245,351
2011-05-08 18:00:00,0,0,63,205,268
2011-05-08 19:00:00,0,0,61,178,239
2011-05-08 20:00:00,0,0,42,132,174
2011-05-08 21:00:00,0,0,32,95,127
2011-05-08 22:00:00,0,0,29,86,115
2011-05-08 23:00:00,0,0,9,41,50
2011-05-09 00:00:00,0,1,31,22,53
2011-05-09 01:00:00,0,1,25,8,33
2011-05-09 02:00:00,0,1,6,2,8
2011-05-09 03:00:00,0,1,0,7,7
2011-05-09 04:00:00,0,1,0,4,4
2011-05-09 05:00:00,0,1,0,23,23
2011-05-09 06:00:00,0,1,2,87,89
2011-05-09 07:00:00,0,1,16,221,237
2011-05-09 08:00:00,0,1,23,351,374
2011-05-09 09:00:00,0,1,36,142,178
2011-05-09 10:00:00,0,1,24,95,119
2011-05-09 11:00:00,0,1,26,99,125
2011-05-09 12:00:00,0,1,35,160,195
2011-05-09 13:00:00,0,1,36,138,174
2011-05-09 14:00:00,0,1,44,118,162
2011-05-09 15:00:00,0,1,51,148,199
2011-05-09 16:00:00,0,1,49,255,304
2011-05-09 17:00:00,0,1,59,539,598
2011-05-09 18:00:00,0,1,66,458,524
2011-05-09 19:00:00,0,1,45,339,384
2011-05-09 20:00:00,0,1,25,214,239
2011-05-09 21:00:00,0,1,28,128,156
2011-05-09 22:00:00,0,1,21,95,116
2011-05-09 23:00:00,0,1,16,45,61
2011-05-10 00:00:00,0,1,6,12,18
2011-05-10 01:00:00,0,1,3,12,15
2011-05-10 02:00:00,0,1,1,4,5
2011-05-10 03:00:00,0,1,1,3,4
2011-05-10 04:00:00,0,1,0,2,2
2011-05-10 05:00:00,0,1,1,28,29
2011-05-10 06:00:00,0,1,9,103,112
2011-05-10 07:00:00,0,1,13,301,314
2011-05-10 08:00:00,0,1,28,397,425
2011-05-10 09:00:00,0,1,29,176,205
2011-05-10 10:00:00,0,1,27,100,127
2011-05-10 11:00:00,0,1,17,108,125
2011-05-10 12:00:00,0,1,47,170,217
2011-05-10 13:00:00,0,1,50,152,202
2011-05-10 14:00:00,0,1,42,134,176
2011-05-10 15:00:00,0,1,28,152,180
2011-05-10 16:00:00,0,1,56,271,327
2011-05-10 17:00:00,0,1,79,532,611
2011-05-10 18:00:00,0,1,70,480,550
2011-05-10 19:00:00,0,1,69,365,434
2011-05-10 20:00:00,0,1,50,241,291
2011-05-10 21:00:00,0,1,30,173,203
2011-05-10 22:00:00,0,1,29,121,150
2011-05-10 23:00:00,0,1,9,72,81
2011-05-11 00:00:00,0,1,8,30,38
2011-05-11 01:00:00,0,1,4,16,20
2011-05-11 02:00:00,0,1,6,4,10
2011-05-11 03:00:00,0,1,0,3,3
2011-05-11 04:00:00,0,1,0,2,2
2011-05-11 05:00:00,0,1,0,20,20
2011-05-11 06:00:00,0,1,6,93,99
2011-05-11 07:00:00,0,1,25,293,318
2011-05-11 08:00:00,0,1,21,421,442
2011-05-11 09:00:00,0,1,21,182,203
2011-05-11 10:00:00,0,1,30,124,154
2011-05-11 11:00:00,0,1,18,123,141
2011-05-11 12:00:00,0,1,41,185,226
2011-05-11 13:00:00,0,1,36,157,193
2011-05-11 14:00:00,0,1,36,141,177
2011-05-11 15:00:00,0,1,48,131,179
2011-05-11 16:00:00,0,1,49,240,289
2011-05-11 17:00:00,0,1,17,242,259
2011-05-11 18:00:00,0,1,40,234,274
2011-05-11 19:00:00,0,1,60,341,401
2011-05-11 20:00:00,0,1,28,245,273
2011-05-11 21:00:00,0,1,32,202,234
2011-05-11 22:00:00,0,1,12,134,146
2011-05-11 23:00:00,0,1,12,69,81
2011-05-12 00:00:00,0,1,5,39,44
2011-05-12 01:00:00,0,1,1,16,17
2011-05-12 02:00:00,0,1,1,14,15
2011-05-12 03:00:00,0,1,0,5,5
2011-05-12 04:00:00,0,1,1,5,6
2011-05-12 05:00:00,0,1,2,27,29
2011-05-12 06:00:00,0,1,9,103,112
2011-05-12 07:00:00,0,1,14,283,297
2011-05-12 08:00:00,0,1,27,394,421
2011-05-12 09:00:00,0,1,21,191,212
2011-05-12 10:00:00,0,1,28,119,147
2011-05-12 11:00:00,0,1,43,136,179
2011-05-12 12:00:00,0,1,43,164,207
2011-05-12 13:00:00,0,1,48,170,218
2011-05-12 14:00:00,0,1,43,148,191
2011-05-12 15:00:00,0,1,54,163,217
2011-05-12 16:00:00,0,1,50,238,288
2011-05-12 17:00:00,0,1,54,540,594
2011-05-12 18:00:00,0,1,64,463,527
2011-05-12 19:00:00,0,1,59,305,364
2011-05-12 20:00:00,0,1,56,220,276
2011-05-12 21:00:00,0,1,31,192,223
2011-05-12 22:00:00,0,1,25,147,172
2011-05-12 23:00:00,0,1,16,87,103
2011-05-13 00:00:00,0,1,6,46,52
2011-05-13 01:00:00,0,1,5,15,20
2011-05-13 02:00:00,0,1,3,8,11
2011-05-13 03:00:00,0,1,2,2,4
2011-05-13 04:00:00,0,1,2,3,5
2011-05-13 05:00:00,0,1,1,24,25
2011-05-13 06:00:00,0,1,6,76,82
2011-05-13 07:00:00,0,1,16,141,157
2011-05-13 08:00:00,0,1,26,361,387
2011-05-13 09:00:00,0,1,18,215,233
2011-05-13 10:00:00,0,1,31,99,130
2011-05-13 11:00:00,0,1,56,90,146
2011-05-13 12:00:00,0,1,53,170,223
2011-05-13 13:00:00,0,1,69,157,226
2011-05-13 14:00:00,0,1,70,120,190
2011-05-13 15:00:00,0,1,56,142,198
2011-05-13 16:00:00,0,1,44,256,300
2011-05-13 17:00:00,0,1,62,429,491
2011-05-13 18:00:00,0,1,39,359,398
2011-05-13 19:00:00,0,1,25,245,270
2011-05-13 20:00:00,0,1,22,130,152
2011-05-13 21:00:00,0,1,24,130,154
2011-05-13 22:00:00,0,1,25,107,132
2011-05-13 23:00:00,0,1,31,88,119
2011-05-14 00:00:00,0,0,24,78,102
2011-05-14 01:00:00,0,0,18,64,82
2011-05-14 02:00:00,0,0,15,37,52
2011-05-14 03:00:00,0,0,5,30,35
2011-05-14 04:00:00,0,0,1,4,5
2011-05-14 05:00:00,0,0,7,7,14
2011-05-14 06:00:00,0,0,2,9,11
2011-05-14 07:00:00,0,0,4,28,32
2011-05-14 08:00:00,0,0,16,72,88
2011-05-14 09:00:00,0,0,14,86,100
2011-05-14 10:00:00,0,0,34,133,167
2011-05-14 11:00:00,0,0,72,207,279
2011-05-14 12:00:00,0,0,75,204,279
2011-05-14 13:00:00,0,0,68,180,248
2011-05-14 14:00:00,0,0,57,159,216
2011-05-14 15:00:00,0,0,73,221,294
2011-05-14 16:00:00,0,0,107,188,295
2011-05-14 17:00:00,0,0,78,194,272
2011-05-14 18:00:00,0,0,88,216,304
2011-05-14 19:00:00,0,0,69,179,248
2011-05-14 20:00:00,0,0,42,115,157
2011-05-14 21:00:00,0,0,15,44,59
2011-05-14 22:00:00,0,0,7,19,26
2011-05-14 23:00:00,0,0,11,33,44
2011-05-15 00:00:00,0,0,5,34,39
2011-05-15 01:00:00,0,0,4,43,47
2011-05-15 02:00:00,0,0,13,37,50
2011-05-15 03:00:00,0,0,11,21,32
2011-05-15 04:00:00,0,0,5,8,13
2011-05-15 05:00:00,0,0,3,11,14
2011-05-15 06:00:00,0,0,3,14,17
2011-05-15 07:00:00,0,0,4,38,42
2011-05-15 08:00:00,0,0,24,46,70
2011-05-15 09:00:00,0,0,36,98,134
2011-05-15 10:00:00,0,0,73,153,226
2011-05-15 11:00:00,0,0,120,202,322
2011-05-15 12:00:00,0,0,120,247,367
2011-05-15 13:00:00,0,0,195,261,456
2011-05-15 14:00:00,0,0,183,254,437
2011-05-15 15:00:00,0,0,206,253,459
2011-05-15 16:00:00,0,0,158,282,440
2011-05-15 17:00:00,0,0,137,255,392
2011-05-15 18:00:00,0,0,60,177,237
2011-05-15 19:00:00,0,0,78,153,231
2011-05-15 20:00:00,0,0,53,138,191
2011-05-15 21:00:00,0,0,44,107,151
2011-05-15 22:00:00,0,0,29,88,117
2011-05-15 23:00:00,0,0,18,51,69
2011-05-16 00:00:00,0,1,17,21,38
2011-05-16 01:00:00,0,1,6,8,14
2011-05-16 02:00:00,0,1,4,9,13
2011-05-16 03:00:00,0,1,1,3,4
2011-05-16 04:00:00,0,1,1,5,6
2011-05-16 05:00:00,0,1,1,20,21
2011-05-16 06:00:00,0,1,11,93,104
2011-05-16 07:00:00,0,1,27,245,272
2011-05-16 08:00:00,0,1,28,366,394
2011-05-16 09:00:00,0,1,38,156,194
2011-05-16 10:00:00,0,1,37,75,112
2011-05-16 11:00:00,0,1,56,129,185
2011-05-16 12:00:00,0,1,72,137,209
2011-05-16 13:00:00,0,1,61,153,214
2011-05-16 14:00:00,0,1,76,117,193
2011-05-16 15:00:00,0,1,55,110,165
2011-05-16 16:00:00,0,1,45,181,226
2011-05-16 17:00:00,0,1,47,227,274
2011-05-16 18:00:00,0,1,55,398,453
2011-05-16 19:00:00,0,1,36,272,308
2011-05-16 20:00:00,0,1,31,167,198
2011-05-16 21:00:00,0,1,28,149,177
2011-05-16 22:00:00,0,1,22,105,127
2011-05-16 23:00:00,0,1,18,39,57
2011-05-17 00:00:00,0,1,13,18,31
2011-05-17 01:00:00,0,1,7,6,13
2011-05-17 02:00:00,0,1,4,4,8
2011-05-17 03:00:00,0,1,1,3,4
2011-05-17 04:00:00,0,1,2,2,4
2011-05-17 05:00:00,0,1,0,22,22
2011-05-17 06:00:00,0,1,0,49,49
2011-05-17 07:00:00,0,1,13,138,151
2011-05-17 08:00:00,0,1,22,325,347
2011-05-17 09:00:00,0,1,17,190,207
2011-05-17 10:00:00,0,1,31,73,104
2011-05-17 11:00:00,0,1,26,104,130
2011-05-17 12:00:00,0,1,38,115,153
2011-05-17 13:00:00,0,1,31,141,172
2011-05-17 14:00:00,0,1,61,123,184
2011-05-17 15:00:00,0,1,79,131,210
2011-05-17 16:00:00,0,1,73,217,290
2011-05-17 17:00:00,0,1,83,521,604
2011-05-17 18:00:00,0,1,54,426,480
2011-05-17 19:00:00,0,1,51,298,349
2011-05-17 20:00:00,0,1,30,253,283
2011-05-17 21:00:00,0,1,23,151,174
2011-05-17 22:00:00,0,1,12,86,98
2011-05-17 23:00:00,0,1,7,49,56
2011-05-18 00:00:00,0,1,8,15,23
2011-05-18 01:00:00,0,1,3,9,12
2011-05-18 02:00:00,0,1,1,5,6
2011-05-18 03:00:00,0,1,6,3,9
2011-05-18 04:00:00,0,1,1,2,3
2011-05-18 05:00:00,0,1,0,9,9
2011-05-18 06:00:00,0,1,2,99,101
2011-05-18 07:00:00,0,1,14,260,274
2011-05-18 08:00:00,0,1,25,428,453
2011-05-18 09:00:00,0,1,26,176,202
2011-05-18 10:00:00,0,1,33,73,106
2011-05-18 11:00:00,0,1,6,17,23
2011-05-18 12:00:00,0,1,12,42,54
2011-05-18 13:00:00,0,1,30,92,122
2011-05-18 14:00:00,0,1,44,94,138
2011-05-18 15:00:00,0,1,34,133,167
2011-05-18 16:00:00,0,1,53,241,294
2011-05-18 17:00:00,0,1,78,487,565
2011-05-18 18:00:00,0,1,58,431,489
2011-05-18 19:00:00,0,1,43,288,331
2011-05-18 20:00:00,0,1,24,189,213
2011-05-18 21:00:00,0,1,11,74,85
2011-05-18 22:00:00,0,1,14,103,117
2011-05-18 23:00:00,0,1,10,49,59
2011-05-19 00:00:00,0,1,6,23,29
2011-05-19 01:00:00,0,1,2,4,6
2011-05-19 02:00:00,0,1,3,12,15
2011-05-19 03:00:00,0,1,1,3,4
2011-05-19 04:00:00,0,1,2,3,5
2011-05-19 05:00:00,0,1,2,24,26
2011-05-19 06:00:00,0,1,17,86,103
2011-05-19 07:00:00,0,1,18,239,257
2011-05-19 08:00:00,0,1,34,453,487
2011-05-19 09:00:00,0,1,40,176,216
2011-05-19 10:00:00,0,1,35,95,130
2011-05-19 11:00:00,0,1,53,111,164
2011-05-19 12:00:00,0,1,38,130,168
2011-05-19 13:00:00,0,1,44,139,183
2011-05-19 14:00:00,0,1,43,137,180
2011-05-19 15:00:00,0,1,63,125,188
2011-05-19 16:00:00,0,1,55,247,302
2011-05-19 17:00:00,0,1,60,487,547
2011-05-19 18:00:00,0,1,59,454,513
2011-05-19 19:00:00,0,1,65,345,410
2011-05-19 20:00:00,0,1,46,236,282
2011-05-19 21:00:00,0,1,29,180,209
2011-05-19 22:00:00,0,1,11,68,79
2011-05-19 23:00:00,0,1,9,63,72
2011-06-01 00:00:00,0,1,9,25,34
2011-06-01 01:00:00,0,1,8,9,17
2011-06-01 02:00:00,0,1,0,3,3
2011-06-01 03:00:00,0,1,0,6,6
2011-06-01 04:00:00,0,1,0,4,4
2011-06-01 05:00:00,0,1,2,19,21
2011-06-01 06:00:00,0,1,7,121,128
2011-06-01 07:00:00,0,1,19,265,284
2011-06-01 08:00:00,0,1,37,417,454
2011-06-01 09:00:00,0,1,34,173,207
2011-06-01 10:00:00,0,1,31,84,115
2011-06-01 11:00:00,0,1,26,86,112
2011-06-01 12:00:00,0,1,32,137,169
2011-06-01 13:00:00,0,1,29,125,154
2011-06-01 14:00:00,0,1,40,105,145
2011-06-01 15:00:00,0,1,25,127,152
2011-06-01 16:00:00,0,1,39,227,266
2011-06-01 17:00:00,0,1,52,434,486
2011-06-01 18:00:00,0,1,31,278,309
2011-06-01 19:00:00,0,1,16,248,264
2011-06-01 20:00:00,0,1,23,233,256
2011-06-01 21:00:00,0,1,29,161,190
2011-06-01 22:00:00,0,1,14,115,129
2011-06-01 23:00:00,0,1,10,59,69
2011-06-02 00:00:00,0,1,11,31,42
2011-06-02 01:00:00,0,1,3,12,15
2011-06-02 02:00:00,0,1,0,6,6
2011-06-02 03:00:00,0,1,0,4,4
2011-06-02 04:00:00,0,1,0,3,3
2011-06-02 05:00:00,0,1,3,28,31
2011-06-02 06:00:00,0,1,7,106,113
2011-06-02 07:00:00,0,1,19,285,304
2011-06-02 08:00:00,0,1,25,442,467
2011-06-02 09:00:00,0,1,28,197,225
2011-06-02 10:00:00,0,1,33,106,139
2011-06-02 11:00:00,0,1,42,123,165
2011-06-02 12:00:00,0,1,39,193,232
2011-06-02 13:00:00,0,1,35,168,203
2011-06-02 14:00:00,0,1,43,142,185
2011-06-02 15:00:00,0,1,44,144,188
2011-06-02 16:00:00,0,1,63,255,318
2011-06-02 17:00:00,0,1,88,484,572
2011-06-02 18:00:00,0,1,74,451,525
2011-06-02 19:00:00,0,1,58,321,379
2011-06-02 20:00:00,0,1,51,286,337
2011-06-02 21:00:00,0,1,33,215,248
2011-06-02 22:00:00,0,1,14,141,155
2011-06-02 23:00:00,0,1,23,89,112
2011-06-03 00:00:00,0,1,15,53,68
2011-06-03 01:00:00,0,1,7,15,22
2011-06-03 02:00:00,0,1,0,12,12
2011-06-03 03:00:00,0,1,0,5,5
2011-06-03 04:00:00,0,1,1,5,6
2011-06-03 05:00:00,0,1,4,24,28
2011-06-03 06:00:00,0,1,8,98,106
2011-06-03 07:00:00,0,1,25,252,277
2011-06-03 08:00:00,0,1,31,471,502
2011-06-03 09:00:00,0,1,36,194,230
2011-06-03 10:00:00,0,1,54,107,161
2011-06-03 11:00:00,0,1,57,135,192
2011-06-03 12:00:00,0,1,51,208,259
2011-06-03 13:00:00,0,1,58,190,248
2011-06-03 14:00:00,0,1,66,174,240
2011-06-03 15:00:00,0,1,56,156,212
2011-06-03 16:00:00,0,1,63,286,349
2011-06-03 17:00:00,0,1,73,485,558
2011-06-03 18:00:00,0,1,76,488,564
2011-06-03 19:00:00,0,1,53,338,391
2011-06-03 20:00:00,0,1,57,236,293
2011-06-03 21:00:00,0,1,51,196,247
2011-06-03 22:00:00,0,1,26,145,171
2011-06-03 23:00:00,0,1,30,141,171
2011-06-04 00:00:00,0,0,24,69,93
2011-06-04 01:00:00,0,0,14,80,94
2011-06-04 02:00:00,0,0,18,41,59
2011-06-04 03:00:00,0,0,8,10,18
2011-06-04 04:00:00,0,0,4,11,15
2011-06-04 05:00:00,0,0,3,5,8
2011-06-04 06:00:00,0,0,11,17,28
2011-06-04 07:00:00,0,0,27,60,87
2011-06-04 08:00:00,0,0,29,96,125
2011-06-04 09:00:00,0,0,55,169,224
2011-06-04 10:00:00,0,0,115,202,317
2011-06-04 11:00:00,0,0,120,249,369
2011-06-04 12:00:00,0,0,150,270,420
2011-06-04 13:00:00,0,0,188,268,456
2011-06-04 14:00:00,0,0,193,258,451
2011-06-04 15:00:00,0,0,180,224,404
2011-06-04 16:00:00,0,0,168,272,440
2011-06-04 17:00:00,0,0,142,202,344
2011-06-04 18:00:00,0,0,127,214,341
2011-06-04 19:00:00,0,0,79,206,285
2011-06-04 20:00:00,0,0,90,149,239
2011-06-04 21:00:00,0,0,46,139,185
2011-06-04 22:00:00,0,0,49,141,190
2011-06-04 23:00:00,0,0,29,121,150
2011-06-05 00:00:00,0,0,23,90,113
2011-06-05 01:00:00,0,0,26,70,96
2011-06-05 02:00:00,0,0,16,48,64
2011-06-05 03:00:00,0,0,22,25,47
2011-06-05 04:00:00,0,0,4,8,12
2011-06-05 05:00:00,0,0,1,5,6
2011-06-05 06:00:00,0,0,10,11,21
2011-06-05 07:00:00,0,0,8,19,27
2011-06-05 08:00:00,0,0,24,74,98
2011-06-05 09:00:00,0,0,53,111,164
2011-06-05 10:00:00,0,0,83,168,251
2011-06-05 11:00:00,0,0,121,214,335
2011-06-05 12:00:00,0,0,123,212,335
2011-06-05 13:00:00,0,0,154,213,367
2011-06-05 14:00:00,0,0,161,224,385
2011-06-05 15:00:00,0,0,161,256,417
2011-06-05 16:00:00,0,0,138,260,398
2011-06-05 17:00:00,0,0,126,264,390
2011-06-05 18:00:00,0,0,124,239,363
2011-06-05 19:00:00,0,0,108,249,357
2011-06-05 20:00:00,0,0,84,195,279
2011-06-05 21:00:00,0,0,54,111,165
2011-06-05 22:00:00,0,0,36,94,130
2011-06-05 23:00:00,0,0,25,61,86
2011-06-06 00:00:00,0,1,11,18,29
2011-06-06 01:00:00,0,1,9,5,14
2011-06-06 02:00:00,0,1,4,4,8
2011-06-06 03:00:00,0,1,2,3,5
2011-06-06 04:00:00,0,1,4,4,8
2011-06-06 05:00:00,0,1,7,24,31
2011-06-06 06:00:00,0,1,11,101,112
2011-06-06 07:00:00,0,1,18,281,299
2011-06-06 08:00:00,0,1,28,410,438
2011-06-06 09:00:00,0,1,26,162,188
2011-06-06 10:00:00,0,1,31,64,95
2011-06-06 11:00:00,0,1,39,72,111
2011-06-06 12:00:00,0,1,25,128,153
2011-06-06 13:00:00,0,1,28,152,180
2011-06-06 14:00:00,0,1,46,99,145
2011-06-06 15:00:00,0,1,38,127,165
2011-06-06 16:00:00,0,1,34,233,267
2011-06-06 17:00:00,0,1,63,516,579
2011-06-06 18:00:00,0,1,56,500,556
2011-06-06 19:00:00,0,1,64,343,407
2011-06-06 20:00:00,0,1,59,277,336
2011-06-06 21:00:00,0,1,29,160,189
2011-06-06 22:00:00,0,1,36,137,173
2011-06-06 23:00:00,0,1,5,55,60
2011-06-07 00:00:00,0,1,5,15,20
2011-06-07 01:00:00,0,1,2,2,4
2011-06-07 02:00:00,0,1,3,2,5
2011-06-07 03:00:00,0,1,1,1,2
2011-06-07 04:00:00,0,1,2,3,5
2011-06-07 05:00:00,0,1,2,30,32
2011-06-07 06:00:00,0,1,10,116,126
2011-06-07 07:00:00,0,1,23,311,334
2011-06-07 08:00:00,0,1,45,432,477
2011-06-07 09:00:00,0,1,27,190,217
2011-06-07 10:00:00,0,1,37,86,123
2011-06-07 11:00:00,0,1,38,113,151
2011-06-07 12:00:00,0,1,42,141,183
2011-06-07 13:00:00,0,1,55,141,196
2011-06-07 14:00:00,0,1,34,112,146
2011-06-07 15:00:00,0,1,56,127,183
2011-06-07 16:00:00,0,1,55,253,308
2011-06-07 17:00:00,0,1,64,475,539
2011-06-07 18:00:00,0,1,72,479,551
2011-06-07 19:00:00,0,1,69,355,424
2011-06-07 20:00:00,0,1,45,301,346
2011-06-07 21:00:00,0,1,31,187,218
2011-06-07 22:00:00,0,1,27,126,153
2011-06-07 23:00:00,0,1,18,72,90
2011-06-08 00:00:00,0,1,12,29,41
2011-06-08 01:00:00,0,1,3,20,23
2011-06-08 02:00:00,0,1,0,7,7
2011-06-08 03:00:00,0,1,2,1,3
2011-06-08 04:00:00,0,1,0,6,6
2011-06-08 05:00:00,0,1,0,21,21
2011-06-08 06:00:00,0,1,13,103,116
2011-06-08 07:00:00,0,1,24,329,353
2011-06-08 08:00:00,0,1,46,435,481
2011-06-08 09:00:00,0,1,34,168,202
2011-06-08 10:00:00,0,1,27,63,90
2011-06-08 11:00:00,0,1,28,106,134
2011-06-08 12:00:00,0,1,15,134,149
2011-06-08 13:00:00,0,1,20,116,136
2011-06-08 14:00:00,0,1,44,111,155
2011-06-08 15:00:00,0,1,28,100,128
2011-06-08 16:00:00,0,1,34,199,233
2011-06-08 17:00:00,0,1,80,426,506
2011-06-08 18:00:00,0,1,61,398,459
2011-06-08 19:00:00,0,1,61,323,384
2011-06-08 20:00:00,0,1,55,225,280
2011-06-08 21:00:00,0,1,34,168,202
2011-06-08 22:00:00,0,1,37,139,176
2011-06-08 23:00:00,0,1,18,98,116
2011-06-09 00:00:00,0,1,7,40,47
2011-06-09 01:00:00,0,1,3,13,16
2011-06-09 02:00:00,0,1,0,6,6
2011-06-09 03:00:00,0,1,0,2,2
2011-06-09 04:00:00,0,1,2,4,6
2011-06-09 05:00:00,0,1,1,19,20
2011-06-09 06:00:00,0,1,13,105,118
2011-06-09 07:00:00,0,1,31,283,314
2011-06-09 08:00:00,0,1,32,400,432
2011-06-09 09:00:00,0,1,20,148,168
2011-06-09 10:00:00,0,1,20,74,94
2011-06-09 11:00:00,0,1,36,82,118
2011-06-09 12:00:00,0,1,40,100,140
2011-06-09 13:00:00,0,1,18,118,136
2011-06-09 14:00:00,0,1,25,93,118
2011-06-09 15:00:00,0,1,18,86,104
2011-06-09 16:00:00,0,1,30,170,200
2011-06-09 17:00:00,0,1,54,355,409
2011-06-09 18:00:00,0,1,52,414,466
2011-06-09 19:00:00,0,1,55,271,326
2011-06-09 20:00:00,0,1,40,214,254
2011-06-09 21:00:00,0,1,29,142,171
2011-06-09 22:00:00,0,1,22,131,153
2011-06-09 23:00:00,0,1,15,82,97
2011-06-10 00:00:00,0,1,8,61,69
2011-06-10 01:00:00,0,1,5,18,23
2011-06-10 02:00:00,0,1,6,7,13
2011-06-10 03:00:00,0,1,3,3,6
2011-06-10 04:00:00,0,1,0,4,4
2011-06-10 05:00:00,0,1,0,28,28
2011-06-10 06:00:00,0,1,10,94,104
2011-06-10 07:00:00,0,1,25,242,267
2011-06-10 08:00:00,0,1,29,423,452
2011-06-10 09:00:00,0,1,37,176,213
2011-06-10 10:00:00,0,1,23,88,111
2011-06-10 11:00:00,0,1,46,107,153
2011-06-10 12:00:00,0,1,40,167,207
2011-06-10 13:00:00,0,1,40,149,189
2011-06-10 14:00:00,0,1,44,121,165
2011-06-10 15:00:00,0,1,49,163,212
2011-06-10 16:00:00,0,1,46,239,285
2011-06-10 17:00:00,0,1,63,454,517
2011-06-10 18:00:00,0,1,96,367,463
2011-06-10 19:00:00,0,1,61,245,306
2011-06-10 20:00:00,0,1,53,197,250
2011-06-10 21:00:00,0,1,55,163,218
2011-06-10 22:00:00,0,1,40,145,185
2011-06-10 23:00:00,0,1,36,110,146
2011-06-11 00:00:00,0,0,28,89,117
2011-06-11 01:00:00,0,0,10,67,77
2011-06-11 02:00:00,0,0,10,50,60
2011-06-11 03:00:00,0,0,10,18,28
2011-06-11 04:00:00,0,0,4,9,13
2011-06-11 05:00:00,0,0,4,12,16
2011-06-11 06:00:00,0,0,9,31,40
2011-06-11 07:00:00,0,0,18,50,68
2011-06-11 08:00:00,0,0,32,111,143
2011-06-11 09:00:00,0,0,59,171,230
2011-06-11 10:00:00,0,0,91,173,264
2011-06-11 11:00:00,0,0,110,215,325
2011-06-11 12:00:00,0,0,112,235,347
2011-06-11 13:00:00,0,0,150,237,387
2011-06-11 14:00:00,0,0,148,232,380
2011-06-11 15:00:00,0,0,142,232,374
2011-06-11 16:00:00,0,0,169,225,394
2011-06-11 17:00:00,0,0,147,190,337
2011-06-11 18:00:00,0,0,131,155,286
2011-06-11 19:00:00,0,0,97,167,264
2011-06-11 20:00:00,0,0,95,180,275
2011-06-11 21:00:00,0,0,76,144,220
2011-06-11 22:00:00,0,0,53,137,190
2011-06-11 23:00:00,0,0,24,107,131
2011-06-12 00:00:00,0,0,19,100,119
2011-06-12 01:00:00,0,0,19,74,93
2011-06-12 02:00:00,0,0,9,57,66
2011-06-12 03:00:00,0,0,8,20,28
2011-06-12 04:00:00,0,0,8,6,14
2011-06-12 05:00:00,0,0,5,5,10
2011-06-12 06:00:00,0,0,5,9,14
2011-06-12 07:00:00,0,0,7,27,34
2011-06-12 08:00:00,0,0,28,64,92
2011-06-12 09:00:00,0,0,75,107,182
2011-06-12 10:00:00,0,0,120,191,311
2011-06-12 11:00:00,0,0,131,236,367
2011-06-12 12:00:00,0,0,176,244,420
2011-06-12 13:00:00,0,0,109,264,373
2011-06-12 14:00:00,0,0,96,219,315
2011-06-12 15:00:00,0,0,142,218,360
2011-06-12 16:00:00,0,0,115,235,350
2011-06-12 17:00:00,0,0,94,158,252
2011-06-12 18:00:00,0,0,69,187,256
2011-06-12 19:00:00,0,0,67,156,223
2011-06-12 20:00:00,0,0,62,144,206
2011-06-12 21:00:00,0,0,39,101,140
2011-06-12 22:00:00,0,0,31,97,128
2011-06-12 23:00:00,0,0,33,74,107
2011-06-13 00:00:00,0,1,8,20,28
2011-06-13 01:00:00,0,1,6,10,16
2011-06-13 02:00:00,0,1,2,8,10
2011-06-13 03:00:00,0,1,1,6,7
2011-06-13 04:00:00,0,1,1,3,4
2011-06-13 05:00:00,0,1,2,27,29
2011-06-13 06:00:00,0,1,7,98,105
2011-06-13 07:00:00,0,1,26,302,328
2011-06-13 08:00:00,0,1,44,432,476
2011-06-13 09:00:00,0,1,35,189,224
2011-06-13 10:00:00,0,1,38,80,118
2011-06-13 11:00:00,0,1,53,106,159
2011-06-13 12:00:00,0,1,35,161,196
2011-06-13 13:00:00,0,1,53,174,227
2011-06-13 14:00:00,0,1,55,145,200
2011-06-13 15:00:00,0,1,58,127,185
2011-06-13 16:00:00,0,1,64,262,326
2011-06-13 17:00:00,0,1,72,529,601
2011-06-13 18:00:00,0,1,76,510,586
2011-06-13 19:00:00,0,1,75,348,423
2011-06-13 20:00:00,0,1,78,253,331
2011-06-13 21:00:00,0,1,40,178,218
2011-06-13 22:00:00,0,1,20,114,134
2011-06-13 23:00:00,0,1,14,75,89
2011-06-14 00:00:00,0,1,13,18,31
2011-06-14 01:00:00,0,1,3,10,13
2011-06-14 02:00:00,0,1,2,8,10
2011-06-14 03:00:00,0,1,1,1,2
2011-06-14 04:00:00,0,1,0,3,3
2011-06-14 05:00:00,0,1,3,23,26
2011-06-14 06:00:00,0,1,6,107,113
2011-06-14 07:00:00,0,1,19,346,365
2011-06-14 08:00:00,0,1,45,441,486
2011-06-14 09:00:00,0,1,19,174,193
2011-06-14 10:00:00,0,1,33,97,130
2011-06-14 11:00:00,0,1,40,103,143
2011-06-14 12:00:00,0,1,30,139,169
2011-06-14 13:00:00,0,1,33,176,209
2011-06-14 14:00:00,0,1,41,118,159
2011-06-14 15:00:00,0,1,42,136,178
2011-06-14 16:00:00,0,1,51,279,330
2011-06-14 17:00:00,0,1,85,484,569
2011-06-14 18:00:00,0,1,65,473,538
2011-06-14 19:00:00,0,1,51,335,386
2011-06-14 20:00:00,0,1,60,237,297
2011-06-14 21:00:00,0,1,37,206,243
2011-06-14 22:00:00,0,1,29,159,188
2011-06-14 23:00:00,0,1,19,91,110
2011-06-15 00:00:00,0,1,8,44,52
2011-06-15 01:00:00,0,1,0,14,14
2011-06-15 02:00:00,0,1,0,9,9
2011-06-15 03:00:00,0,1,0,1,1
2011-06-15 04:00:00,0,1,0,4,4
2011-06-15 05:00:00,0,1,1,20,21
2011-06-15 06:00:00,0,1,11,110,121
2011-06-15 07:00:00,0,1,22,348,370
2011-06-15 08:00:00,0,1,53,445,498
2011-06-15 09:00:00,0,1,22,185,207
2011-06-15 10:00:00,0,1,27,108,135
2011-06-15 11:00:00,0,1,49,115,164
2011-06-15 12:00:00,0,1,33,178,211
2011-06-15 13:00:00,0,1,43,146,189
2011-06-15 14:00:00,0,1,50,128,178
2011-06-15 15:00:00,0,1,33,131,164
2011-06-15 16:00:00,0,1,47,265,312
2011-06-15 17:00:00,0,1,83,555,638
2011-06-15 18:00:00,0,1,80,527,607
2011-06-15 19:00:00,0,1,54,362,416
2011-06-15 20:00:00,0,1,57,273,330
2011-06-15 21:00:00,0,1,48,209,257
2011-06-15 22:00:00,0,1,31,144,175
2011-06-15 23:00:00,0,1,17,90,107
2011-06-16 00:00:00,0,1,9,38,47
2011-06-16 01:00:00,0,1,4,13,17
2011-06-16 02:00:00,0,1,1,4,5
2011-06-16 03:00:00,0,1,0,4,4
2011-06-16 04:00:00,0,1,0,6,6
2011-06-16 05:00:00,0,1,7,18,25
2011-06-16 06:00:00,0,1,8,104,112
2011-06-16 07:00:00,0,1,16,172,188
2011-06-16 08:00:00,0,1,24,364,388
2011-06-16 09:00:00,0,1,29,232,261
2011-06-16 10:00:00,0,1,18,103,121
2011-06-16 11:00:00,0,1,33,117,150
2011-06-16 12:00:00,0,1,41,165,206
2011-06-16 13:00:00,0,1,37,114,151
2011-06-16 14:00:00,0,1,39,114,153
2011-06-16 15:00:00,0,1,32,127,159
2011-06-16 16:00:00,0,1,36,258,294
2011-06-16 17:00:00,0,1,42,230,272
2011-06-16 18:00:00,0,1,26,299,325
2011-06-16 19:00:00,0,1,58,269,327
2011-06-16 20:00:00,0,1,25,176,201
2011-06-16 21:00:00,0,1,34,154,188
2011-06-16 22:00:00,0,1,24,127,151
2011-06-16 23:00:00,0,1,2,14,16
2011-06-17 00:00:00,0,1,3,21,24
2011-06-17 01:00:00,0,1,4,19,23
2011-06-17 02:00:00,0,1,2,11,13
2011-06-17 03:00:00,0,1,1,5,6
2011-06-17 04:00:00,0,1,1,5,6
2011-06-17 05:00:00,0,1,1,12,13
2011-06-17 06:00:00,0,1,8,89,97
2011-06-17 07:00:00,0,1,25,225,250
2011-06-17 08:00:00,0,1,28,426,454
2011-06-17 09:00:00,0,1,28,196,224
2011-06-17 10:00:00,0,1,44,126,170
2011-06-17 11:00:00,0,1,43,138,181
2011-06-17 12:00:00,0,1,49,194,243
2011-06-17 13:00:00,0,1,48,156,204
2011-06-17 14:00:00,0,1,73,142,215
2011-06-17 15:00:00,0,1,62,181,243
2011-06-17 16:00:00,0,1,69,286,355
2011-06-17 17:00:00,0,1,85,467,552
2011-06-17 18:00:00,0,1,62,388,450
2011-06-17 19:00:00,0,1,53,275,328
2011-06-17 20:00:00,0,1,40,192,232
2011-06-17 21:00:00,0,1,49,159,208
2011-06-17 22:00:00,0,1,48,127,175
2011-06-17 23:00:00,0,1,37,141,178
2011-06-18 00:00:00,0,0,21,83,104
2011-06-18 01:00:00,0,0,15,80,95
2011-06-18 02:00:00,0,0,16,37,53
2011-06-18 03:00:00,0,0,4,16,20
2011-06-18 04:00:00,0,0,1,4,5
2011-06-18 05:00:00,0,0,1,6,7
2011-06-18 06:00:00,0,0,9,18,27
2011-06-18 07:00:00,0,0,12,45,57
2011-06-18 08:00:00,0,0,28,103,131
2011-06-18 09:00:00,0,0,62,156,218
2011-06-18 10:00:00,0,0,68,176,244
2011-06-18 11:00:00,0,0,134,270,404
2011-06-18 12:00:00,0,0,162,258,420
2011-06-18 13:00:00,0,0,135,192,327
2011-06-18 14:00:00,0,0,138,196,334
2011-06-18 15:00:00,0,0,153,214,367
2011-06-18 16:00:00,0,0,193,275,468
2011-06-18 17:00:00,0,0,210,239,449
2011-06-18 18:00:00,0,0,118,263,381
2011-06-18 19:00:00,0,0,99,227,326
2011-06-18 20:00:00,0,0,61,127,188
2011-06-18 21:00:00,0,0,58,125,183
2011-06-18 22:00:00,0,0,56,105,161
2011-06-18 23:00:00,0,0,53,97,150
2011-06-19 00:00:00,0,0,18,71,89
2011-06-19 01:00:00,0,0,17,59,76
2011-06-19 02:00:00,0,0,13,59,72
2011-06-19 03:00:00,0,0,14,16,30
2011-06-19 04:00:00,0,0,7,10,17
2011-06-19 05:00:00,0,0,7,12,19
2011-06-19 06:00:00,0,0,11,22,33
2011-06-19 07:00:00,0,0,35,36,71
2011-06-19 08:00:00,0,0,25,59,84
2011-06-19 09:00:00,0,0,58,111,169
2011-06-19 10:00:00,0,0,86,158,244
2011-06-19 11:00:00,0,0,141,236,377
2011-06-19 12:00:00,0,0,141,255,396
2011-06-19 13:00:00,0,0,149,214,363
2011-06-19 14:00:00,0,0,124,193,317
2011-06-19 15:00:00,0,0,146,216,362
2011-06-19 16:00:00,0,0,121,257,378
2011-06-19 17:00:00,0,0,159,238,397
2011-06-19 18:00:00,0,0,78,218,296
2011-06-19 19:00:00,0,0,94,217,311
2011-06-19 20:00:00,0,0,86,146,232
2011-06-19 21:00:00,0,0,57,110,167
2011-06-19 22:00:00,0,0,38,114,152
2011-06-19 23:00:00,0,0,14,78,92
2011-07-01 00:00:00,0,1,20,48,68
2011-07-01 01:00:00,0,1,15,16,31
2011-07-01 02:00:00,0,1,6,7,13
2011-07-01 03:00:00,0,1,5,6,11
2011-07-01 04:00:00,0,1,1,5,6
2011-07-01 05:00:00,0,1,3,27,30
2011-07-01 06:00:00,0,1,11,97,108
2011-07-01 07:00:00,0,1,25,218,243
2011-07-01 08:00:00,0,1,39,453,492
2011-07-01 09:00:00,0,1,58,202,260
2011-07-01 10:00:00,0,1,61,109,170
2011-07-01 11:00:00,0,1,68,146,214
2011-07-01 12:00:00,0,1,83,180,263
2011-07-01 13:00:00,0,1,83,209,292
2011-07-01 14:00:00,0,1,78,225,303
2011-07-01 15:00:00,0,1,82,299,381
2011-07-01 16:00:00,0,1,85,342,427
2011-07-01 17:00:00,0,1,99,362,461
2011-07-01 18:00:00,0,1,98,324,422
2011-07-01 19:00:00,0,1,80,238,318
2011-07-01 20:00:00,0,1,84,185,269
2011-07-01 21:00:00,0,1,69,149,218
2011-07-01 22:00:00,0,1,49,173,222
2011-07-01 23:00:00,0,1,44,96,140
2011-07-02 00:00:00,0,0,31,84,115
2011-07-02 01:00:00,0,0,20,58,78
2011-07-02 02:00:00,0,0,9,43,52
2011-07-02 03:00:00,0,0,5,21,26
2011-07-02 04:00:00,0,0,3,8,11
2011-07-02 05:00:00,0,0,1,13,14
2011-07-02 06:00:00,0,0,11,21,32
2011-07-02 07:00:00,0,0,10,35,45
2011-07-02 08:00:00,0,0,38,94,132
2011-07-02 09:00:00,0,0,55,124,179
2011-07-02 10:00:00,0,0,103,168,271
2011-07-02 11:00:00,0,0,144,213,357
2011-07-02 12:00:00,0,0,142,232,374
2011-07-02 13:00:00,0,0,178,226,404
2011-07-02 14:00:00,0,0,177,215,392
2011-07-02 15:00:00,0,0,168,163,331
2011-07-02 16:00:00,0,0,206,192,398
2011-07-02 17:00:00,0,0,179,170,349
2011-07-02 18:00:00,0,0,193,190,383
2011-07-02 19:00:00,0,0,156,149,305
2011-07-02 20:00:00,0,0,136,148,284
2011-07-02 21:00:00,0,0,95,137,232
2011-07-02 22:00:00,0,0,78,123,201
2011-07-02 23:00:00,0,0,66,88,154
2011-07-03 00:00:00,0,0,47,97,144
2011-07-03 01:00:00,0,0,23,55,78
2011-07-03 02:00:00,0,0,19,50,69
2011-07-03 03:00:00,0,0,8,25,33
2011-07-03 04:00:00,0,0,3,2,5
2011-07-03 05:00:00,0,0,0,1,1
2011-07-03 06:00:00,0,0,0,3,3
2011-07-03 07:00:00,0,0,3,22,25
2011-07-03 08:00:00,0,0,39,53,92
2011-07-03 09:00:00,0,0,82,99,181
2011-07-03 10:00:00,0,0,131,133,264
2011-07-03 11:00:00,0,0,215,175,390
2011-07-03 12:00:00,0,0,198,206,404
2011-07-03 13:00:00,0,0,248,173,421
2011-07-03 14:00:00,0,0,225,150,375
2011-07-03 15:00:00,0,0,194,182,376
2011-07-03 16:00:00,0,0,195,219,414
2011-07-03 17:00:00,0,0,181,177,358
2011-07-03 18:00:00,0,0,74,107,181
2011-07-03 19:00:00,0,0,100,83,183
2011-07-03 20:00:00,0,0,83,93,176
2011-07-03 21:00:00,0,0,75,92,167
2011-07-03 22:00:00,0,0,69,93,162
2011-07-03 23:00:00,0,0,70,77,147
2011-07-04 00:00:00,1,0,63,77,140
2011-07-04 01:00:00,1,0,43,76,119
2011-07-04 02:00:00,1,0,33,30,63
2011-07-04 03:00:00,1,0,13,13,26
2011-07-04 04:00:00,1,0,8,4,12
2011-07-04 05:00:00,1,0,1,3,4
2011-07-04 06:00:00,1,0,5,11,16
2011-07-04 07:00:00,1,0,17,19,36
2011-07-04 08:00:00,1,0,42,44,86
2011-07-04 09:00:00,1,0,142,96,238
2011-07-04 10:00:00,1,0,166,114,280
2011-07-04 11:00:00,1,0,177,172,349
2011-07-04 12:00:00,1,0,237,210,447
2011-07-04 13:00:00,1,0,242,181,423
2011-07-04 14:00:00,1,0,235,173,408
2011-07-04 15:00:00,1,0,224,184,408
2011-07-04 16:00:00,1,0,236,216,452
2011-07-04 17:00:00,1,0,240,196,436
2011-07-04 18:00:00,1,0,222,196,418
2011-07-04 19:00:00,1,0,170,205,375
2011-07-04 20:00:00,1,0,195,191,386
2011-07-04 21:00:00,1,0,195,262,457
2011-07-04 22:00:00,1,0,115,211,326
2011-07-04 23:00:00,1,0,44,94,138
2011-07-05 00:00:00,0,1,19,36,55
2011-07-05 01:00:00,0,1,15,24,39
2011-07-05 02:00:00,0,1,8,5,13
2011-07-05 03:00:00,0,1,1,7,8
2011-07-05 04:00:00,0,1,1,4,5
2011-07-05 05:00:00,0,1,1,19,20
2011-07-05 06:00:00,0,1,3,91,94
2011-07-05 07:00:00,0,1,22,248,270
2011-07-05 08:00:00,0,1,41,391,432
2011-07-05 09:00:00,0,1,50,177,227
2011-07-05 10:00:00,0,1,55,84,139
2011-07-05 11:00:00,0,1,75,97,172
2011-07-05 12:00:00,0,1,71,130,201
2011-07-05 13:00:00,0,1,67,136,203
2011-07-05 14:00:00,0,1,66,112,178
2011-07-05 15:00:00,0,1,51,111,162
2011-07-05 16:00:00,0,1,79,202,281
2011-07-05 17:00:00,0,1,79,466,545
2011-07-05 18:00:00,0,1,70,426,496
2011-07-05 19:00:00,0,1,71,297,368
2011-07-05 20:00:00,0,1,59,225,284
2011-07-05 21:00:00,0,1,77,168,245
2011-07-05 22:00:00,0,1,31,124,155
2011-07-05 23:00:00,0,1,19,54,73
2011-07-06 00:00:00,0,1,11,26,37
2011-07-06 01:00:00,0,1,4,11,15
2011-07-06 02:00:00,0,1,1,4,5
2011-07-06 03:00:00,0,1,0,6,6
2011-07-06 04:00:00,0,1,0,6,6
2011-07-06 05:00:00,0,1,5,30,35
2011-07-06 06:00:00,0,1,9,112,121
2011-07-06 07:00:00,0,1,24,288,312
2011-07-06 08:00:00,0,1,31,397,428
2011-07-06 09:00:00,0,1,31,158,189
2011-07-06 10:00:00,0,1,13,30,43
2011-07-06 11:00:00,0,1,24,103,127
2011-07-06 12:00:00,0,1,38,114,152
2011-07-06 13:00:00,0,1,33,107,140
2011-07-06 14:00:00,0,1,50,113,163
2011-07-06 15:00:00,0,1,55,130,185
2011-07-06 16:00:00,0,1,57,218,275
2011-07-06 17:00:00,0,1,79,517,596
2011-07-06 18:00:00,0,1,77,486,563
2011-07-06 19:00:00,0,1,71,323,394
2011-07-06 20:00:00,0,1,55,257,312
2011-07-06 21:00:00,0,1,66,175,241
2011-07-06 22:00:00,0,1,30,156,186
2011-07-06 23:00:00,0,1,20,78,98
2011-07-07 00:00:00,0,1,6,29,35
2011-07-07 01:00:00,0,1,2,14,16
2011-07-07 02:00:00,0,1,1,7,8
2011-07-07 03:00:00,0,1,2,2,4
2011-07-07 04:00:00,0,1,0,4,4
2011-07-07 05:00:00,0,1,2,30,32
2011-07-07 06:00:00,0,1,11,107,118
2011-07-07 07:00:00,0,1,13,279,292
2011-07-07 08:00:00,0,1,28,415,443
2011-07-07 09:00:00,0,1,25,154,179
2011-07-07 10:00:00,0,1,29,72,101
2011-07-07 11:00:00,0,1,30,112,142
2011-07-07 12:00:00,0,1,32,139,171
2011-07-07 13:00:00,0,1,48,107,155
2011-07-07 14:00:00,0,1,39,121,160
2011-07-07 15:00:00,0,1,47,119,166
2011-07-07 16:00:00,0,1,47,218,265
2011-07-07 17:00:00,0,1,80,489,569
2011-07-07 18:00:00,0,1,70,492,562
2011-07-07 19:00:00,0,1,79,286,365
2011-07-07 20:00:00,0,1,61,224,285
2011-07-07 21:00:00,0,1,39,170,209
2011-07-07 22:00:00,0,1,32,150,182
2011-07-07 23:00:00,0,1,31,98,129
2011-07-08 00:00:00,0,1,6,41,47
2011-07-08 01:00:00,0,1,9,25,34
2011-07-08 02:00:00,0,1,10,12,22
2011-07-08 03:00:00,0,1,2,4,6
2011-07-08 04:00:00,0,1,7,4,11
2011-07-08 05:00:00,0,1,3,24,27
2011-07-08 06:00:00,0,1,11,91,102
2011-07-08 07:00:00,0,1,30,302,332
2011-07-08 08:00:00,0,1,36,421,457
2011-07-08 09:00:00,0,1,30,211,241
2011-07-08 10:00:00,0,1,30,108,138
2011-07-08 11:00:00,0,1,61,104,165
2011-07-08 12:00:00,0,1,49,164,213
2011-07-08 13:00:00,0,1,54,175,229
2011-07-08 14:00:00,0,1,53,163,216
2011-07-08 15:00:00,0,1,39,102,141
2011-07-08 16:00:00,0,1,27,105,132
2011-07-08 17:00:00,0,1,6,161,167
2011-07-08 18:00:00,0,1,35,281,316
2011-07-08 19:00:00,0,1,45,225,270
2011-07-08 20:00:00,0,1,30,220,250
2011-07-08 21:00:00,0,1,46,158,204
2011-07-08 22:00:00,0,1,33,136,169
2011-07-08 23:00:00,0,1,40,111,151
2011-07-09 00:00:00,0,0,31,90,121
2011-07-09 01:00:00,0,0,5,48,53
2011-07-09 02:00:00,0,0,12,43,55
2011-07-09 03:00:00,0,0,7,23,30
2011-07-09 04:00:00,0,0,2,4,6
2011-07-09 05:00:00,0,0,4,11,15
2011-07-09 06:00:00,0,0,11,27,38
2011-07-09 07:00:00,0,0,21,50,71
2011-07-09 08:00:00,0,0,68,114,182
2011-07-09 09:00:00,0,0,77,170,247
2011-07-09 10:00:00,0,0,87,177,264
2011-07-09 11:00:00,0,0,101,189,290
2011-07-09 12:00:00,0,0,145,221,366
2011-07-09 13:00:00,0,0,167,249,416
2011-07-09 14:00:00,0,0,158,215,373
2011-07-09 15:00:00,0,0,182,220,402
2011-07-09 16:00:00,0,0,171,245,416
2011-07-09 17:00:00,0,0,160,241,401
2011-07-09 18:00:00,0,0,132,246,378
2011-07-09 19:00:00,0,0,128,178,306
2011-07-09 20:00:00,0,0,129,185,314
2011-07-09 21:00:00,0,0,83,155,238
2011-07-09 22:00:00,0,0,60,154,214
2011-07-09 23:00:00,0,0,47,93,140
2011-07-10 00:00:00,0,0,42,112,154
2011-07-10 01:00:00,0,0,19,94,113
2011-07-10 02:00:00,0,0,28,68,96
2011-07-10 03:00:00,0,0,6,19,25
2011-07-10 04:00:00,0,0,0,5,5
2011-07-10 05:00:00,0,0,7,10,17
2011-07-10 06:00:00,0,0,8,17,25
2011-07-10 07:00:00,0,0,27,38,65
2011-07-10 08:00:00,0,0,27,65,92
2011-07-10 09:00:00,0,0,62,107,169
2011-07-10 10:00:00,0,0,95,173,268
2011-07-10 11:00:00,0,0,110,177,287
2011-07-10 12:00:00,0,0,133,244,377
2011-07-10 13:00:00,0,0,139,228,367
2011-07-10 14:00:00,0,0,122,227,349
2011-07-10 15:00:00,0,0,142,219,361
2011-07-10 16:00:00,0,0,128,244,372
2011-07-10 17:00:00,0,0,146,217,363
2011-07-10 18:00:00,0,0,141,222,363
2011-07-10 19:00:00,0,0,120,183,303
2011-07-10 20:00:00,0,0,101,167,268
2011-07-10 21:00:00,0,0,65,162,227
2011-07-10 22:00:00,0,0,56,87,143
2011-07-10 23:00:00,0,0,19,53,72
2011-07-11 00:00:00,0,1,10,25,35
2011-07-11 01:00:00,0,1,5,5,10
2011-07-11 02:00:00,0,1,8,4,12
2011-07-11 03:00:00,0,1,2,8,10
2011-07-11 04:00:00,0,1,0,4,4
2011-07-11 05:00:00,0,1,5,21,26
2011-07-11 06:00:00,0,1,19,102,121
2011-07-11 07:00:00,0,1,28,289,317
2011-07-11 08:00:00,0,1,35,385,420
2011-07-11 09:00:00,0,1,41,167,208
2011-07-11 10:00:00,0,1,44,73,117
2011-07-11 11:00:00,0,1,39,89,128
2011-07-11 12:00:00,0,1,40,108,148
2011-07-11 13:00:00,0,1,22,119,141
2011-07-11 14:00:00,0,1,40,94,134
2011-07-11 15:00:00,0,1,38,108,146
2011-07-11 16:00:00,0,1,57,182,239
2011-07-11 17:00:00,0,1,59,455,514
2011-07-11 18:00:00,0,1,57,415,472
2011-07-11 19:00:00,0,1,80,293,373
2011-07-11 20:00:00,0,1,42,194,236
2011-07-11 21:00:00,0,1,21,109,130
2011-07-11 22:00:00,0,1,20,70,90
2011-07-11 23:00:00,0,1,11,44,55
2011-07-12 00:00:00,0,1,3,19,22
2011-07-12 01:00:00,0,1,6,8,14
2011-07-12 02:00:00,0,1,2,7,9
2011-07-12 03:00:00,0,1,2,6,8
2011-07-12 04:00:00,0,1,0,6,6
2011-07-12 05:00:00,0,1,4,21,25
2011-07-12 06:00:00,0,1,13,102,115
2011-07-12 07:00:00,0,1,29,301,330
2011-07-12 08:00:00,0,1,35,382,417
2011-07-12 09:00:00,0,1,27,149,176
2011-07-12 10:00:00,0,1,38,85,123
2011-07-12 11:00:00,0,1,39,86,125
2011-07-12 12:00:00,0,1,38,125,163
2011-07-12 13:00:00,0,1,32,104,136
2011-07-12 14:00:00,0,1,33,91,124
2011-07-12 15:00:00,0,1,37,111,148
2011-07-12 16:00:00,0,1,25,177,202
2011-07-12 17:00:00,0,1,48,380,428
2011-07-12 18:00:00,0,1,39,472,511
2011-07-12 19:00:00,0,1,42,295,337
2011-07-12 20:00:00,0,1,57,251,308
2011-07-12 21:00:00,0,1,49,209,258
2011-07-12 22:00:00,0,1,44,150,194
2011-07-12 23:00:00,0,1,20,59,79
2011-07-13 00:00:00,0,1,9,37,46
2011-07-13 01:00:00,0,1,1,11,12
2011-07-13 02:00:00,0,1,2,3,5
2011-07-13 03:00:00,0,1,0,4,4
2011-07-13 04:00:00,0,1,0,5,5
2011-07-13 05:00:00,0,1,4,22,26
2011-07-13 06:00:00,0,1,18,103,121
2011-07-13 07:00:00,0,1,32,281,313
2011-07-13 08:00:00,0,1,31,418,449
2011-07-13 09:00:00,0,1,23,163,186
2011-07-13 10:00:00,0,1,33,80,113
2011-07-13 11:00:00,0,1,55,110,165
2011-07-13 12:00:00,0,1,40,134,174
2011-07-13 13:00:00,0,1,39,119,158
2011-07-13 14:00:00,0,1,27,89,116
2011-07-13 15:00:00,0,1,13,33,46
2011-07-13 16:00:00,0,1,23,118,141
2011-07-13 17:00:00,0,1,70,418,488
2011-07-13 18:00:00,0,1,51,412,463
2011-07-13 19:00:00,0,1,79,340,419
2011-07-13 20:00:00,0,1,61,281,342
2011-07-13 21:00:00,0,1,56,194,250
2011-07-13 22:00:00,0,1,48,136,184
2011-07-13 23:00:00,0,1,33,83,116
2011-07-14 00:00:00,0,1,14,32,46
2011-07-14 01:00:00,0,1,4,21,25
2011-07-14 02:00:00,0,1,3,7,10
2011-07-14 03:00:00,0,1,1,5,6
2011-07-14 04:00:00,0,1,0,6,6
2011-07-14 05:00:00,0,1,6,22,28
2011-07-14 06:00:00,0,1,14,116,130
2011-07-14 07:00:00,0,1,23,311,334
2011-07-14 08:00:00,0,1,53,433,486
2011-07-14 09:00:00,0,1,29,195,224
2011-07-14 10:00:00,0,1,32,95,127
2011-07-14 11:00:00,0,1,38,110,148
2011-07-14 12:00:00,0,1,51,172,223
2011-07-14 13:00:00,0,1,39,138,177
2011-07-14 14:00:00,0,1,49,129,178
2011-07-14 15:00:00,0,1,42,138,180
2011-07-14 16:00:00,0,1,43,231,274
2011-07-14 17:00:00,0,1,78,517,595
2011-07-14 18:00:00,0,1,94,484,578
2011-07-14 19:00:00,0,1,67,333,400
2011-07-14 20:00:00,0,1,81,267,348
2011-07-14 21:00:00,0,1,58,203,261
2011-07-14 22:00:00,0,1,42,134,176
2011-07-14 23:00:00,0,1,27,97,124
2011-07-15 00:00:00,0,1,23,57,80
2011-07-15 01:00:00,0,1,7,13,20
2011-07-15 02:00:00,0,1,16,22,38
2011-07-15 03:00:00,0,1,1,6,7
2011-07-15 04:00:00,0,1,2,8,10
2011-07-15 05:00:00,0,1,7,16,23
2011-07-15 06:00:00,0,1,12,108,120
2011-07-15 07:00:00,0,1,17,257,274
2011-07-15 08:00:00,0,1,50,514,564
2011-07-15 09:00:00,0,1,31,176,207
2011-07-15 10:00:00,0,1,59,107,166
2011-07-15 11:00:00,0,1,73,137,210
2011-07-15 12:00:00,0,1,61,177,238
2011-07-15 13:00:00,0,1,85,162,247
2011-07-15 14:00:00,0,1,105,160,265
2011-07-15 15:00:00,0,1,74,163,237
2011-07-15 16:00:00,0,1,96,265,361
2011-07-15 17:00:00,0,1,104,483,587
2011-07-15 18:00:00,0,1,102,394,496
2011-07-15 19:00:00,0,1,114,280,394
2011-07-15 20:00:00,0,1,92,251,343
2011-07-15 21:00:00,0,1,75,186,261
2011-07-15 22:00:00,0,1,71,152,223
2011-07-15 23:00:00,0,1,41,126,167
2011-07-16 00:00:00,0,0,42,68,110
2011-07-16 01:00:00,0,0,24,51,75
2011-07-16 02:00:00,0,0,10,48,58
2011-07-16 03:00:00,0,0,6,20,26
2011-07-16 04:00:00,0,0,9,7,16
2011-07-16 05:00:00,0,0,4,6,10
2011-07-16 06:00:00,0,0,16,21,37
2011-07-16 07:00:00,0,0,14,38,52
2011-07-16 08:00:00,0,0,37,90,127
2011-07-16 09:00:00,0,0,72,150,222
2011-07-16 10:00:00,0,0,114,208,322
2011-07-16 11:00:00,0,0,171,225,396
2011-07-16 12:00:00,0,0,187,276,463
2011-07-16 13:00:00,0,0,221,276,497
2011-07-16 14:00:00,0,0,201,232,433
2011-07-16 15:00:00,0,0,205,223,428
2011-07-16 16:00:00,0,0,183,242,425
2011-07-16 17:00:00,0,0,234,241,475
2011-07-16 18:00:00,0,0,185,243,428
2011-07-16 19:00:00,0,0,164,242,406
2011-07-16 20:00:00,0,0,108,188,296
2011-07-16 21:00:00,0,0,85,167,252
2011-07-16 22:00:00,0,0,65,136,201
2011-07-16 23:00:00,0,0,61,107,168
2011-07-17 00:00:00,0,0,34,91,125
2011-07-17 01:00:00,0,0,16,86,102
2011-07-17 02:00:00,0,0,28,66,94
2011-07-17 03:00:00,0,0,21,26,47
2011-07-17 04:00:00,0,0,4,6,10
2011-07-17 05:00:00,0,0,4,8,12
2011-07-17 06:00:00,0,0,10,11,21
2011-07-17 07:00:00,0,0,20,30,50
2011-07-17 08:00:00,0,0,45,73,118
2011-07-17 09:00:00,0,0,74,110,184
2011-07-17 10:00:00,0,0,127,177,304
2011-07-17 11:00:00,0,0,147,244,391
2011-07-17 12:00:00,0,0,177,243,420
2011-07-17 13:00:00,0,0,200,272,472
2011-07-17 14:00:00,0,0,168,262,430
2011-07-17 15:00:00,0,0,129,195,324
2011-07-17 16:00:00,0,0,129,188,317
2011-07-17 17:00:00,0,0,133,236,369
2011-07-17 18:00:00,0,0,147,243,390
2011-07-17 19:00:00,0,0,145,234,379
2011-07-17 20:00:00,0,0,85,177,262
2011-07-17 21:00:00,0,0,59,148,207
2011-07-17 22:00:00,0,0,65,116,181
2011-07-17 23:00:00,0,0,39,54,93
2011-07-18 00:00:00,0,1,21,30,51
2011-07-18 01:00:00,0,1,17,8,25
2011-07-18 02:00:00,0,1,2,8,10
2011-07-18 03:00:00,0,1,3,4,7
2011-07-18 04:00:00,0,1,1,3,4
2011-07-18 05:00:00,0,1,2,15,17
2011-07-18 06:00:00,0,1,10,95,105
2011-07-18 07:00:00,0,1,22,255,277
2011-07-18 08:00:00,0,1,18,329,347
2011-07-18 09:00:00,0,1,33,170,203
2011-07-18 10:00:00,0,1,52,78,130
2011-07-18 11:00:00,0,1,42,99,141
2011-07-18 12:00:00,0,1,39,126,165
2011-07-18 13:00:00,0,1,27,125,152
2011-07-18 14:00:00,0,1,32,106,138
2011-07-18 15:00:00,0,1,53,111,164
2011-07-18 16:00:00,0,1,45,220,265
2011-07-18 17:00:00,0,1,72,473,545
2011-07-18 18:00:00,0,1,80,478,558
2011-07-18 19:00:00,0,1,63,335,398
2011-07-18 20:00:00,0,1,91,232,323
2011-07-18 21:00:00,0,1,48,154,202
2011-07-18 22:00:00,0,1,36,104,140
2011-07-18 23:00:00,0,1,32,59,91
2011-07-19 00:00:00,0,1,25,26,51
2011-07-19 01:00:00,0,1,7,6,13
2011-07-19 02:00:00,0,1,9,4,13
2011-07-19 03:00:00,0,1,2,1,3
2011-07-19 04:00:00,0,1,1,4,5
2011-07-19 05:00:00,0,1,0,19,19
2011-07-19 06:00:00,0,1,8,126,134
2011-07-19 07:00:00,0,1,28,287,315
2011-07-19 08:00:00,0,1,31,381,412
2011-07-19 09:00:00,0,1,22,177,199
2011-07-19 10:00:00,0,1,29,112,141
2011-07-19 11:00:00,0,1,29,98,127
2011-07-19 12:00:00,0,1,26,127,153
2011-07-19 13:00:00,0,1,33,139,172
2011-07-19 14:00:00,0,1,41,111,152
2011-07-19 15:00:00,0,1,48,110,158
2011-07-19 16:00:00,0,1,61,216,277
2011-07-19 17:00:00,0,1,68,445,513
2011-07-19 18:00:00,0,1,80,450,530
2011-07-19 19:00:00,0,1,54,334,388
2011-07-19 20:00:00,0,1,48,229,277
2011-07-19 21:00:00,0,1,47,194,241
2011-07-19 22:00:00,0,1,36,120,156
2011-07-19 23:00:00,0,1,19,73,92
2011-08-01 00:00:00,0,1,7,22,29
2011-08-01 01:00:00,0,1,5,12,17
2011-08-01 02:00:00,0,1,4,7,11
2011-08-01 03:00:00,0,1,0,4,4
2011-08-01 04:00:00,0,1,2,2,4
2011-08-01 05:00:00,0,1,2,24,26
2011-08-01 06:00:00,0,1,3,97,100
2011-08-01 07:00:00,0,1,24,258,282
2011-08-01 08:00:00,0,1,35,347,382
2011-08-01 09:00:00,0,1,27,139,166
2011-08-01 10:00:00,0,1,27,70,97
2011-08-01 11:00:00,0,1,53,66,119
2011-08-01 12:00:00,0,1,53,115,168
2011-08-01 13:00:00,0,1,38,112,150
2011-08-01 14:00:00,0,1,37,86,123
2011-08-01 15:00:00,0,1,52,77,129
2011-08-01 16:00:00,0,1,34,197,231
2011-08-01 17:00:00,0,1,69,445,514
2011-08-01 18:00:00,0,1,68,475,543
2011-08-01 19:00:00,0,1,63,350,413
2011-08-01 20:00:00,0,1,49,256,305
2011-08-01 21:00:00,0,1,42,178,220
2011-08-01 22:00:00,0,1,21,116,137
2011-08-01 23:00:00,0,1,14,82,96
2011-08-02 00:00:00,0,1,11,18,29
2011-08-02 01:00:00,0,1,4,8,12
2011-08-02 02:00:00,0,1,2,6,8
2011-08-02 03:00:00,0,1,0,5,5
2011-08-02 04:00:00,0,1,0,10,10
2011-08-02 05:00:00,0,1,4,17,21
2011-08-02 06:00:00,0,1,12,105,117
2011-08-02 07:00:00,0,1,15,320,335
2011-08-02 08:00:00,0,1,37,398,435
2011-08-02 09:00:00,0,1,31,182,213
2011-08-02 10:00:00,0,1,50,90,140
2011-08-02 11:00:00,0,1,32,96,128
2011-08-02 12:00:00,0,1,45,112,157
2011-08-02 13:00:00,0,1,50,153,203
2011-08-02 14:00:00,0,1,45,114,159
2011-08-02 15:00:00,0,1,48,120,168
2011-08-02 16:00:00,0,1,58,216,274
2011-08-02 17:00:00,0,1,63,493,556
2011-08-02 18:00:00,0,1,65,491,556
2011-08-02 19:00:00,0,1,85,369,454
2011-08-02 20:00:00,0,1,40,248,288
2011-08-02 21:00:00,0,1,53,201,254
2011-08-02 22:00:00,0,1,22,169,191
2011-08-02 23:00:00,0,1,29,103,132
2011-08-03 00:00:00,0,1,11,32,43
2011-08-03 01:00:00,0,1,7,9,16
2011-08-03 02:00:00,0,1,2,9,11
2011-08-03 03:00:00,0,1,0,4,4
2011-08-03 04:00:00,0,1,0,7,7
2011-08-03 05:00:00,0,1,2,22,24
2011-08-03 06:00:00,0,1,9,101,110
2011-08-03 07:00:00,0,1,19,252,271
2011-08-03 08:00:00,0,1,29,408,437
2011-08-03 09:00:00,0,1,23,172,195
2011-08-03 10:00:00,0,1,9,59,68
2011-08-03 11:00:00,0,1,29,93,122
2011-08-03 12:00:00,0,1,19,142,161
2011-08-03 13:00:00,0,1,37,107,144
2011-08-03 14:00:00,0,1,43,104,147
2011-08-03 15:00:00,0,1,31,87,118
2011-08-03 16:00:00,0,1,21,129,150
2011-08-03 17:00:00,0,1,47,378,425
2011-08-03 18:00:00,0,1,49,443,492
2011-08-03 19:00:00,0,1,51,270,321
2011-08-03 20:00:00,0,1,7,80,87
2011-08-03 21:00:00,0,1,7,81,88
2011-08-03 22:00:00,0,1,11,66,77
2011-08-03 23:00:00,0,1,4,52,56
2011-08-04 00:00:00,0,1,2,15,17
2011-08-04 01:00:00,0,1,3,14,17
2011-08-04 02:00:00,0,1,2,5,7
2011-08-04 03:00:00,0,1,0,3,3
2011-08-04 04:00:00,0,1,0,7,7
2011-08-04 05:00:00,0,1,3,17,20
2011-08-04 06:00:00,0,1,7,90,97
2011-08-04 07:00:00,0,1,11,271,282
2011-08-04 08:00:00,0,1,29,369,398
2011-08-04 09:00:00,0,1,25,162,187
2011-08-04 10:00:00,0,1,24,89,113
2011-08-04 11:00:00,0,1,37,112,149
2011-08-04 12:00:00,0,1,53,152,205
2011-08-04 13:00:00,0,1,63,142,205
2011-08-04 14:00:00,0,1,53,114,167
2011-08-04 15:00:00,0,1,50,115,165
2011-08-04 16:00:00,0,1,70,220,290
2011-08-04 17:00:00,0,1,91,464,555
2011-08-04 18:00:00,0,1,88,435,523
2011-08-04 19:00:00,0,1,65,301,366
2011-08-04 20:00:00,0,1,41,245,286
2011-08-04 21:00:00,0,1,25,186,211
2011-08-04 22:00:00,0,1,33,141,174
2011-08-04 23:00:00,0,1,24,108,132
2011-08-05 00:00:00,0,1,13,41,54
2011-08-05 01:00:00,0,1,3,16,19
2011-08-05 02:00:00,0,1,5,14,19
2011-08-05 03:00:00,0,1,0,6,6
2011-08-05 04:00:00,0,1,1,6,7
2011-08-05 05:00:00,0,1,0,16,16
2011-08-05 06:00:00,0,1,7,94,101
2011-08-05 07:00:00,0,1,23,247,270
2011-08-05 08:00:00,0,1,39,415,454
2011-08-05 09:00:00,0,1,43,183,226
2011-08-05 10:00:00,0,1,50,113,163
2011-08-05 11:00:00,0,1,44,103,147
2011-08-05 12:00:00,0,1,57,159,216
2011-08-05 13:00:00,0,1,40,164,204
2011-08-05 14:00:00,0,1,81,164,245
2011-08-05 15:00:00,0,1,50,160,210
2011-08-05 16:00:00,0,1,76,254,330
2011-08-05 17:00:00,0,1,84,466,550
2011-08-05 18:00:00,0,1,105,361,466
2011-08-05 19:00:00,0,1,90,282,372
2011-08-05 20:00:00,0,1,70,221,291
2011-08-05 21:00:00,0,1,54,119,173
2011-08-05 22:00:00,0,1,51,137,188
2011-08-05 23:00:00,0,1,37,102,139
2011-08-06 00:00:00,0,0,29,104,133
2011-08-06 01:00:00,0,0,17,50,67
2011-08-06 02:00:00,0,0,14,39,53
2011-08-06 03:00:00,0,0,14,28,42
2011-08-06 04:00:00,0,0,5,5,10
2011-08-06 05:00:00,0,0,2,4,6
2011-08-06 06:00:00,0,0,5,22,27
2011-08-06 07:00:00,0,0,14,49,63
2011-08-06 08:00:00,0,0,27,94,121
2011-08-06 09:00:00,0,0,60,155,215
2011-08-06 10:00:00,0,0,91,199,290
2011-08-06 11:00:00,0,0,138,211,349
2011-08-06 12:00:00,0,0,130,252,382
2011-08-06 13:00:00,0,0,176,265,441
2011-08-06 14:00:00,0,0,176,204,380
2011-08-06 15:00:00,0,0,130,232,362
2011-08-06 16:00:00,0,0,155,188,343
2011-08-06 17:00:00,0,0,61,88,149
2011-08-06 18:00:00,0,0,81,130,211
2011-08-06 19:00:00,0,0,57,114,171
2011-08-06 20:00:00,0,0,58,79,137
2011-08-06 21:00:00,0,0,28,86,114
2011-08-06 22:00:00,0,0,24,96,120
2011-08-06 23:00:00,0,0,29,79,108
2011-08-07 00:00:00,0,0,14,66,80
2011-08-07 01:00:00,0,0,10,63,73
2011-08-07 02:00:00,0,0,18,48,66
2011-08-07 03:00:00,0,0,9,23,32
2011-08-07 04:00:00,0,0,1,5,6
2011-08-07 05:00:00,0,0,1,4,5
2011-08-07 06:00:00,0,0,3,10,13
2011-08-07 07:00:00,0,0,11,28,39
2011-08-07 08:00:00,0,0,23,66,89
2011-08-07 09:00:00,0,0,82,102,184
2011-08-07 10:00:00,0,0,88,178,266
2011-08-07 11:00:00,0,0,113,156,269
2011-08-07 12:00:00,0,0,161,209,370
2011-08-07 13:00:00,0,0,118,206,324
2011-08-07 14:00:00,0,0,130,192,322
2011-08-07 15:00:00,0,0,118,208,326
2011-08-07 16:00:00,0,0,74,119,193
2011-08-07 17:00:00,0,0,63,131,194
2011-08-07 18:00:00,0,0,74,155,229
2011-08-07 19:00:00,0,0,68,160,228
2011-08-07 20:00:00,0,0,50,133,183
2011-08-07 21:00:00,0,0,36,100,136
2011-08-07 22:00:00,0,0,21,82,103
2011-08-07 23:00:00,0,0,12,43,55
2011-08-08 00:00:00,0,1,13,17,30
2011-08-08 01:00:00,0,1,4,8,12
2011-08-08 02:00:00,0,1,4,3,7
2011-08-08 03:00:00,0,1,1,0,1
2011-08-08 04:00:00,0,1,2,8,10
2011-08-08 05:00:00,0,1,1,14,15
2011-08-08 06:00:00,0,1,8,87,95
2011-08-08 07:00:00,0,1,18,249,267
2011-08-08 08:00:00,0,1,29,320,349
2011-08-08 09:00:00,0,1,37,146,183
2011-08-08 10:00:00,0,1,62,62,124
2011-08-08 11:00:00,0,1,90,89,179
2011-08-08 12:00:00,0,1,48,134,182
2011-08-08 13:00:00,0,1,43,108,151
2011-08-08 14:00:00,0,1,41,109,150
2011-08-08 15:00:00,0,1,40,86,126
2011-08-08 16:00:00,0,1,64,218,282
2011-08-08 17:00:00,0,1,67,460,527
2011-08-08 18:00:00,0,1,64,465,529
2011-08-08 19:00:00,0,1,64,352,416
2011-08-08 20:00:00,0,1,71,215,286
2011-08-08 21:00:00,0,1,30,156,186
2011-08-08 22:00:00,0,1,26,121,147
2011-08-08 23:00:00,0,1,19,53,72
2011-08-09 00:00:00,0,1,10,25,35
2011-08-09 01:00:00,0,1,5,9,14
2011-08-09 02:00:00,0,1,9,3,12
2011-08-09 03:00:00,0,1,0,3,3
2011-08-09 04:00:00,0,1,1,6,7
2011-08-09 05:00:00,0,1,5,25,30
2011-08-09 06:00:00,0,1,6,95,101
2011-08-09 07:00:00,0,1,30,313,343
2011-08-09 08:00:00,0,1,40,352,392
2011-08-09 09:00:00,0,1,34,141,175
2011-08-09 10:00:00,0,1,55,89,144
2011-08-09 11:00:00,0,1,61,88,149
2011-08-09 12:00:00,0,1,60,125,185
2011-08-09 13:00:00,0,1,48,127,175
2011-08-09 14:00:00,0,1,53,95,148
2011-08-09 15:00:00,0,1,58,106,164
2011-08-09 16:00:00,0,1,57,228,285
2011-08-09 17:00:00,0,1,79,453,532
2011-08-09 18:00:00,0,1,97,488,585
2011-08-09 19:00:00,0,1,69,302,371
2011-08-09 20:00:00,0,1,34,258,292
2011-08-09 21:00:00,0,1,46,184,230
2011-08-09 22:00:00,0,1,28,127,155
2011-08-09 23:00:00,0,1,22,53,75
2011-08-10 00:00:00,0,1,19,18,37
2011-08-10 01:00:00,0,1,7,10,17
2011-08-10 02:00:00,0,1,1,10,11
2011-08-10 03:00:00,0,1,1,3,4
2011-08-10 04:00:00,0,1,1,4,5
2011-08-10 05:00:00,0,1,2,30,32
2011-08-10 06:00:00,0,1,9,110,119
2011-08-10 07:00:00,0,1,16,289,305
2011-08-10 08:00:00,0,1,38,361,399
2011-08-10 09:00:00,0,1,32,148,180
2011-08-10 10:00:00,0,1,41,72,113
2011-08-10 11:00:00,0,1,54,95,149
2011-08-10 12:00:00,0,1,74,166,240
2011-08-10 13:00:00,0,1,41,150,191
2011-08-10 14:00:00,0,1,62,116,178
2011-08-10 15:00:00,0,1,53,141,194
2011-08-10 16:00:00,0,1,76,206,282
2011-08-10 17:00:00,0,1,71,513,584
2011-08-10 18:00:00,0,1,70,489,559
2011-08-10 19:00:00,0,1,79,334,413
2011-08-10 20:00:00,0,1,59,253,312
2011-08-10 21:00:00,0,1,47,162,209
2011-08-10 22:00:00,0,1,17,122,139
2011-08-10 23:00:00,0,1,14,94,108
2011-08-11 00:00:00,0,1,6,40,46
2011-08-11 01:00:00,0,1,9,17,26
2011-08-11 02:00:00,0,1,3,8,11
2011-08-11 03:00:00,0,1,2,7,9
2011-08-11 04:00:00,0,1,1,4,5
2011-08-11 05:00:00,0,1,2,23,25
2011-08-11 06:00:00,0,1,5,101,106
2011-08-11 07:00:00,0,1,15,292,307
2011-08-11 08:00:00,0,1,29,361,390
2011-08-11 09:00:00,0,1,31,166,197
2011-08-11 10:00:00,0,1,36,96,132
2011-08-11 11:00:00,0,1,59,128,187
2011-08-11 12:00:00,0,1,50,164,214
2011-08-11 13:00:00,0,1,51,166,217
2011-08-11 14:00:00,0,1,39,103,142
2011-08-11 15:00:00,0,1,52,126,178
2011-08-11 16:00:00,0,1,57,241,298
2011-08-11 17:00:00,0,1,96,486,582
2011-08-11 18:00:00,0,1,74,497,571
2011-08-11 19:00:00,0,1,48,323,371
2011-08-11 20:00:00,0,1,56,232,288
2011-08-11 21:00:00,0,1,35,171,206
2011-08-11 22:00:00,0,1,34,123,157
2011-08-11 23:00:00,0,1,22,105,127
2011-08-12 00:00:00,0,1,12,53,65
2011-08-12 01:00:00,0,1,4,19,23
2011-08-12 02:00:00,0,1,0,15,15
2011-08-12 03:00:00,0,1,0,9,9
2011-08-12 04:00:00,0,1,0,5,5
2011-08-12 05:00:00,0,1,2,24,26
2011-08-12 06:00:00,0,1,3,73,76
2011-08-12 07:00:00,0,1,17,247,264
2011-08-12 08:00:00,0,1,29,397,426
2011-08-12 09:00:00,0,1,27,178,205
2011-08-12 10:00:00,0,1,44,86,130
2011-08-12 11:00:00,0,1,48,108,156
2011-08-12 12:00:00,0,1,55,167,222
2011-08-12 13:00:00,0,1,74,179,253
2011-08-12 14:00:00,0,1,51,135,186
2011-08-12 15:00:00,0,1,59,190,249
2011-08-12 16:00:00,0,1,68,266,334
2011-08-12 17:00:00,0,1,93,423,516
2011-08-12 18:00:00,0,1,89,376,465
2011-08-12 19:00:00,0,1,101,284,385
2011-08-12 20:00:00,0,1,77,210,287
2011-08-12 21:00:00,0,1,73,153,226
2011-08-12 22:00:00,0,1,74,157,231
2011-08-12 23:00:00,0,1,51,100,151
2011-08-13 00:00:00,0,0,15,69,84
2011-08-13 01:00:00,0,0,13,64,77
2011-08-13 02:00:00,0,0,16,58,74
2011-08-13 03:00:00,0,0,9,18,27
2011-08-13 04:00:00,0,0,5,5,10
2011-08-13 05:00:00,0,0,3,15,18
2011-08-13 06:00:00,0,0,3,19,22
2011-08-13 07:00:00,0,0,10,34,44
2011-08-13 08:00:00,0,0,28,90,118
2011-08-13 09:00:00,0,0,70,138,208
2011-08-13 10:00:00,0,0,97,163,260
2011-08-13 11:00:00,0,0,122,192,314
2011-08-13 12:00:00,0,0,175,246,421
2011-08-13 13:00:00,0,0,61,92,153
2011-08-13 14:00:00,0,0,113,146,259
2011-08-13 15:00:00,0,0,150,208,358
2011-08-13 16:00:00,0,0,148,133,281
2011-08-13 17:00:00,0,0,97,172,269
2011-08-13 18:00:00,0,0,123,169,292
2011-08-13 19:00:00,0,0,67,170,237
2011-08-13 20:00:00,0,0,78,105,183
2011-08-13 21:00:00,0,0,40,127,167
2011-08-13 22:00:00,0,0,36,118,154
2011-08-13 23:00:00,0,0,25,95,120
2011-08-14 00:00:00,0,0,19,71,90
2011-08-14 01:00:00,0,0,16,57,73
2011-08-14 02:00:00,0,0,13,49,62
2011-08-14 03:00:00,0,0,5,22,27
2011-08-14 04:00:00,0,0,1,2,3
2011-08-14 05:00:00,0,0,1,9,10
2011-08-14 06:00:00,0,0,2,4,6
2011-08-14 07:00:00,0,0,4,20,24
2011-08-14 08:00:00,0,0,20,21,41
2011-08-14 09:00:00,0,0,27,76,103
2011-08-14 10:00:00,0,0,67,116,183
2011-08-14 11:00:00,0,0,81,117,198
2011-08-14 12:00:00,0,0,98,183,281
2011-08-14 13:00:00,0,0,144,233,377
2011-08-14 14:00:00,0,0,126,244,370
2011-08-14 15:00:00,0,0,128,203,331
2011-08-14 16:00:00,0,0,116,176,292
2011-08-14 17:00:00,0,0,133,196,329
2011-08-14 18:00:00,0,0,125,222,347
2011-08-14 19:00:00,0,0,75,184,259
2011-08-14 20:00:00,0,0,67,126,193
2011-08-14 21:00:00,0,0,51,104,155
2011-08-14 22:00:00,0,0,14,25,39
2011-08-14 23:00:00,0,0,5,22,27
2011-08-15 00:00:00,0,1,7,18,25
2011-08-15 01:00:00,0,1,1,9,10
2011-08-15 02:00:00,0,1,0,3,3
2011-08-15 03:00:00,0,1,1,6,7
2011-08-15 04:00:00,0,1,1,4,5
2011-08-15 05:00:00,0,1,3,14,17
2011-08-15 06:00:00,0,1,3,87,90
2011-08-15 07:00:00,0,1,10,248,258
2011-08-15 08:00:00,0,1,29,326,355
2011-08-15 09:00:00,0,1,52,170,222
2011-08-15 10:00:00,0,1,54,87,141
2011-08-15 11:00:00,0,1,41,112,153
2011-08-15 12:00:00,0,1,62,116,178
2011-08-15 13:00:00,0,1,53,140,193
2011-08-15 14:00:00,0,1,56,95,151
2011-08-15 15:00:00,0,1,49,133,182
2011-08-15 16:00:00,0,1,58,225,283
2011-08-15 17:00:00,0,1,59,471,530
2011-08-15 18:00:00,0,1,70,413,483
2011-08-15 19:00:00,0,1,54,343,397
2011-08-15 20:00:00,0,1,45,240,285
2011-08-15 21:00:00,0,1,34,150,184
2011-08-15 22:00:00,0,1,22,76,98
2011-08-15 23:00:00,0,1,11,77,88
2011-08-16 00:00:00,0,1,8,23,31
2011-08-16 01:00:00,0,1,4,12,16
2011-08-16 02:00:00,0,1,1,3,4
2011-08-16 03:00:00,0,1,1,5,6
2011-08-16 04:00:00,0,1,0,5,5
2011-08-16 05:00:00,0,1,1,29,30
2011-08-16 06:00:00,0,1,4,115,119
2011-08-16 07:00:00,0,1,18,328,346
2011-08-16 08:00:00,0,1,24,417,441
2011-08-16 09:00:00,0,1,27,171,198
2011-08-16 10:00:00,0,1,28,83,111
2011-08-16 11:00:00,0,1,40,110,150
2011-08-16 12:00:00,0,1,42,120,162
2011-08-16 13:00:00,0,1,45,147,192
2011-08-16 14:00:00,0,1,65,117,182
2011-08-16 15:00:00,0,1,36,123,159
2011-08-16 16:00:00,0,1,55,248,303
2011-08-16 17:00:00,0,1,75,525,600
2011-08-16 18:00:00,0,1,54,516,570
2011-08-16 19:00:00,0,1,56,320,376
2011-08-16 20:00:00,0,1,48,232,280
2011-08-16 21:00:00,0,1,38,177,215
2011-08-16 22:00:00,0,1,31,121,152
2011-08-16 23:00:00,0,1,20,57,77
2011-08-17 00:00:00,0,1,8,16,24
2011-08-17 01:00:00,0,1,2,12,14
2011-08-17 02:00:00,0,1,0,6,6
2011-08-17 03:00:00,0,1,1,4,5
2011-08-17 04:00:00,0,1,0,5,5
2011-08-17 05:00:00,0,1,0,28,28
2011-08-17 06:00:00,0,1,4,101,105
2011-08-17 07:00:00,0,1,12,296,308
2011-08-17 08:00:00,0,1,35,452,487
2011-08-17 09:00:00,0,1,31,178,209
2011-08-17 10:00:00,0,1,27,91,118
2011-08-17 11:00:00,0,1,20,108,128
2011-08-17 12:00:00,0,1,26,163,189
2011-08-17 13:00:00,0,1,38,138,176
2011-08-17 14:00:00,0,1,54,138,192
2011-08-17 15:00:00,0,1,42,117,159
2011-08-17 16:00:00,0,1,62,238,300
2011-08-17 17:00:00,0,1,46,506,552
2011-08-17 18:00:00,0,1,86,470,556
2011-08-17 19:00:00,0,1,50,297,347
2011-08-17 20:00:00,0,1,37,243,280
2011-08-17 21:00:00,0,1,38,192,230
2011-08-17 22:00:00,0,1,29,142,171
2011-08-17 23:00:00,0,1,20,85,105
2011-08-18 00:00:00,0,1,18,38,56
2011-08-18 01:00:00,0,1,13,11,24
2011-08-18 02:00:00,0,1,2,4,6
2011-08-18 03:00:00,0,1,0,6,6
2011-08-18 04:00:00,0,1,0,9,9
2011-08-18 05:00:00,0,1,0,27,27
2011-08-18 06:00:00,0,1,6,97,103
2011-08-18 07:00:00,0,1,19,289,308
2011-08-18 08:00:00,0,1,27,393,420
2011-08-18 09:00:00,0,1,42,186,228
2011-08-18 10:00:00,0,1,37,92,129
2011-08-18 11:00:00,0,1,44,97,141
2011-08-18 12:00:00,0,1,34,139,173
2011-08-18 13:00:00,0,1,33,154,187
2011-08-18 14:00:00,0,1,67,115,182
2011-08-18 15:00:00,0,1,56,118,174
2011-08-18 16:00:00,0,1,49,196,245
2011-08-18 17:00:00,0,1,44,365,409
2011-08-18 18:00:00,0,1,48,226,274
2011-08-18 19:00:00,0,1,26,115,141
2011-08-18 20:00:00,0,1,24,141,165
2011-08-18 21:00:00,0,1,12,137,149
2011-08-18 22:00:00,0,1,18,117,135
2011-08-18 23:00:00,0,1,20,94,114
2011-08-19 00:00:00,0,1,9,53,62
2011-08-19 01:00:00,0,1,1,19,20
2011-08-19 02:00:00,0,1,0,8,8
2011-08-19 03:00:00,0,1,2,1,3
2011-08-19 04:00:00,0,1,1,7,8
2011-08-19 05:00:00,0,1,1,16,17
2011-08-19 06:00:00,0,1,2,91,93
2011-08-19 07:00:00,0,1,12,251,263
2011-08-19 08:00:00,0,1,30,368,398
2011-08-19 09:00:00,0,1,31,187,218
2011-08-19 10:00:00,0,1,57,108,165
2011-08-19 11:00:00,0,1,45,120,165
2011-08-19 12:00:00,0,1,54,168,222
2011-08-19 13:00:00,0,1,63,169,232
2011-08-19 14:00:00,0,1,78,142,220
2011-08-19 15:00:00,0,1,66,156,222
2011-08-19 16:00:00,0,1,66,261,327
2011-08-19 17:00:00,0,1,85,442,527
2011-08-19 18:00:00,0,1,88,337,425
2011-08-19 19:00:00,0,1,33,132,165
2011-08-19 20:00:00,0,1,12,46,58
2011-08-19 21:00:00,0,1,18,89,107
2011-08-19 22:00:00,0,1,25,97,122
2011-08-19 23:00:00,0,1,18,88,106
2011-09-01 00:00:00,0,1,18,33,51
2011-09-01 01:00:00,0,1,7,14,21
2011-09-01 02:00:00,0,1,14,11,25
2011-09-01 03:00:00,0,1,7,7,14
2011-09-01 04:00:00,0,1,0,7,7
2011-09-01 05:00:00,0,1,1,22,23
2011-09-01 06:00:00,0,1,2,103,105
2011-09-01 07:00:00,0,1,7,335,342
2011-09-01 08:00:00,0,1,31,467,498
2011-09-01 09:00:00,0,1,29,178,207
2011-09-01 10:00:00,0,1,46,92,138
2011-09-01 11:00:00,0,1,51,141,192
2011-09-01 12:00:00,0,1,64,165,229
2011-09-01 13:00:00,0,1,50,169,219
2011-09-01 14:00:00,0,1,54,144,198
2011-09-01 15:00:00,0,1,39,135,174
2011-09-01 16:00:00,0,1,55,253,308
2011-09-01 17:00:00,0,1,61,567,628
2011-09-01 18:00:00,0,1,69,462,531
2011-09-01 19:00:00,0,1,79,364,443
2011-09-01 20:00:00,0,1,33,247,280
2011-09-01 21:00:00,0,1,17,160,177
2011-09-01 22:00:00,0,1,34,145,179
2011-09-01 23:00:00,0,1,15,111,126
2011-09-02 00:00:00,0,1,6,58,64
2011-09-02 01:00:00,0,1,4,28,32
2011-09-02 02:00:00,0,1,9,11,20
2011-09-02 03:00:00,0,1,4,4,8
2011-09-02 04:00:00,0,1,2,2,4
2011-09-02 05:00:00,0,1,0,20,20
2011-09-02 06:00:00,0,1,3,73,76
2011-09-02 07:00:00,0,1,6,253,259
2011-09-02 08:00:00,0,1,22,434,456
2011-09-02 09:00:00,0,1,30,190,220
2011-09-02 10:00:00,0,1,34,106,140
2011-09-02 11:00:00,0,1,51,141,192
2011-09-02 12:00:00,0,1,82,178,260
2011-09-02 13:00:00,0,1,72,207,279
2011-09-02 14:00:00,0,1,75,208,283
2011-09-02 15:00:00,0,1,69,277,346
2011-09-02 16:00:00,0,1,82,299,381
2011-09-02 17:00:00,0,1,78,377,455
2011-09-02 18:00:00,0,1,50,305,355
2011-09-02 19:00:00,0,1,67,220,287
2011-09-02 20:00:00,0,1,38,158,196
2011-09-02 21:00:00,0,1,28,121,149
2011-09-02 22:00:00,0,1,33,114,147
2011-09-02 23:00:00,0,1,30,68,98
2011-09-03 00:00:00,0,0,22,65,87
2011-09-03 01:00:00,0,0,17,57,74
2011-09-03 02:00:00,0,0,15,26,41
2011-09-03 03:00:00,0,0,17,18,35
2011-09-03 04:00:00,0,0,3,4,7
2011-09-03 05:00:00,0,0,3,9,12
2011-09-03 06:00:00,0,0,4,19,23
2011-09-03 07:00:00,0,0,5,33,38
2011-09-03 08:00:00,0,0,24,65,89
2011-09-03 09:00:00,0,0,83,118,201
2011-09-03 10:00:00,0,0,90,168,258
2011-09-03 11:00:00,0,0,66,128,194
2011-09-03 12:00:00,0,0,97,160,257
2011-09-03 13:00:00,0,0,153,200,353
2011-09-03 14:00:00,0,0,204,176,380
2011-09-03 15:00:00,0,0,187,201,388
2011-09-03 16:00:00,0,0,186,188,374
2011-09-03 17:00:00,0,0,170,201,371
2011-09-03 18:00:00,0,0,160,179,339
2011-09-03 19:00:00,0,0,147,148,295
2011-09-03 20:00:00,0,0,99,120,219
2011-09-03 21:00:00,0,0,71,93,164
2011-09-03 22:00:00,0,0,66,96,162
2011-09-03 23:00:00,0,0,46,77,123
2011-09-04 00:00:00,0,0,33,76,109
2011-09-04 01:00:00,0,0,37,38,75
2011-09-04 02:00:00,0,0,17,43,60
2011-09-04 03:00:00,0,0,20,23,43
2011-09-04 04:00:00,0,0,0,4,4
2011-09-04 05:00:00,0,0,1,5,6
2011-09-04 06:00:00,0,0,0,3,3
2011-09-04 07:00:00,0,0,10,20,30
2011-09-04 08:00:00,0,0,21,49,70
2011-09-04 09:00:00,0,0,87,102,189
2011-09-04 10:00:00,0,0,150,147,297
2011-09-04 11:00:00,0,0,174,163,337
2011-09-04 12:00:00,0,0,214,221,435
2011-09-04 13:00:00,0,0,245,174,419
2011-09-04 14:00:00,0,0,205,156,361
2011-09-04 15:00:00,0,0,218,192,410
2011-09-04 16:00:00,0,0,196,141,337
2011-09-04 17:00:00,0,0,204,172,376
2011-09-04 18:00:00,0,0,187,169,356
2011-09-04 19:00:00,0,0,178,150,328
2011-09-04 20:00:00,0,0,104,125,229
2011-09-04 21:00:00,0,0,104,103,207
2011-09-04 22:00:00,0,0,70,85,155
2011-09-04 23:00:00,0,0,46,58,104
2011-09-05 00:00:00,1,0,31,66,97
2011-09-05 01:00:00,1,0,19,35,54
2011-09-05 02:00:00,1,0,17,22,39
2011-09-05 03:00:00,1,0,4,12,16
2011-09-05 04:00:00,1,0,3,5,8
2011-09-05 05:00:00,1,0,2,4,6
2011-09-05 06:00:00,1,0,6,5,11
2011-09-05 07:00:00,1,0,11,30,41
2011-09-05 08:00:00,1,0,45,56,101
2011-09-05 09:00:00,1,0,63,89,152
2011-09-05 10:00:00,1,0,107,137,244
2011-09-05 11:00:00,1,0,101,207,308
2011-09-05 12:00:00,1,0,141,212,353
2011-09-05 13:00:00,1,0,154,235,389
2011-09-05 14:00:00,1,0,145,212,357
2011-09-05 15:00:00,1,0,111,142,253
2011-09-05 16:00:00,1,0,92,192,284
2011-09-05 17:00:00,1,0,37,77,114
2011-09-05 18:00:00,1,0,31,92,123
2011-09-05 19:00:00,1,0,52,123,175
2011-09-05 20:00:00,1,0,26,56,82
2011-09-05 21:00:00,1,0,20,40,60
2011-09-05 22:00:00,1,0,15,49,64
2011-09-05 23:00:00,1,0,3,17,20
2011-09-06 00:00:00,0,1,1,7,8
2011-09-06 02:00:00,0,1,0,2,2
2011-09-06 03:00:00,0,1,1,0,1
2011-09-06 04:00:00,0,1,1,3,4
2011-09-06 05:00:00,0,1,1,20,21
2011-09-06 06:00:00,0,1,0,72,72
2011-09-06 07:00:00,0,1,6,166,172
2011-09-06 08:00:00,0,1,15,349,364
2011-09-06 09:00:00,0,1,18,167,185
2011-09-06 10:00:00,0,1,16,90,106
2011-09-06 11:00:00,0,1,11,78,89
2011-09-06 12:00:00,0,1,16,51,67
2011-09-06 13:00:00,0,1,5,24,29
2011-09-06 14:00:00,0,1,3,21,24
2011-09-06 15:00:00,0,1,18,71,89
2011-09-06 16:00:00,0,1,11,95,106
2011-09-06 17:00:00,0,1,15,276,291
2011-09-06 18:00:00,0,1,22,351,373
2011-09-06 19:00:00,0,1,12,269,281
2011-09-06 20:00:00,0,1,13,150,163
2011-09-06 21:00:00,0,1,12,109,121
2011-09-06 22:00:00,0,1,5,79,84
2011-09-06 23:00:00,0,1,2,56,58
2011-09-07 00:00:00,0,1,1,12,13
2011-09-07 01:00:00,0,1,2,3,5
2011-09-07 02:00:00,0,1,2,4,6
2011-09-07 03:00:00,0,1,1,1,2
2011-09-07 04:00:00,0,1,0,4,4
2011-09-07 05:00:00,0,1,1,15,16
2011-09-07 06:00:00,0,1,1,74,75
2011-09-07 07:00:00,0,1,3,83,86
2011-09-07 08:00:00,0,1,9,319,328
2011-09-07 09:00:00,0,1,14,176,190
2011-09-07 10:00:00,0,1,3,63,66
2011-09-07 11:00:00,0,1,1,9,10
2011-09-07 12:00:00,0,1,1,21,22
2011-09-07 13:00:00,0,1,2,9,11
2011-09-07 14:00:00,0,1,1,24,25
2011-09-07 15:00:00,0,1,3,55,58
2011-09-07 16:00:00,0,1,7,137,144
2011-09-07 17:00:00,0,1,21,264,285
2011-09-07 18:00:00,0,1,18,219,237
2011-09-07 19:00:00,0,1,14,212,226
2011-09-07 20:00:00,0,1,3,93,96
2011-09-07 21:00:00,0,1,4,34,38
2011-09-07 22:00:00,0,1,3,26,29
2011-09-07 23:00:00,0,1,3,21,24
2011-09-08 00:00:00,0,1,3,11,14
2011-09-08 01:00:00,0,1,0,4,4
2011-09-08 03:00:00,0,1,0,2,2
2011-09-08 04:00:00,0,1,0,3,3
2011-09-08 05:00:00,0,1,1,13,14
2011-09-08 06:00:00,0,1,1,55,56
2011-09-08 07:00:00,0,1,7,172,179
2011-09-08 08:00:00,0,1,7,188,195
2011-09-08 09:00:00,0,1,4,65,69
2011-09-08 10:00:00,0,1,8,57,65
2011-09-08 11:00:00,0,1,16,82,98
2011-09-08 12:00:00,0,1,17,85,102
2011-09-08 13:00:00,0,1,14,112,126
2011-09-08 14:00:00,0,1,15,105,120
2011-09-08 15:00:00,0,1,24,115,139
2011-09-08 16:00:00,0,1,5,151,156
2011-09-08 17:00:00,0,1,11,102,113
2011-09-08 18:00:00,0,1,2,66,68
2011-09-08 19:00:00,0,1,1,51,52
2011-09-08 20:00:00,0,1,6,83,89
2011-09-08 21:00:00,0,1,6,76,82
2011-09-08 22:00:00,0,1,5,65,70
2011-09-08 23:00:00,0,1,0,26,26
2011-09-09 00:00:00,0,1,1,15,16
2011-09-09 01:00:00,0,1,0,8,8
2011-09-09 02:00:00,0,1,1,7,8
2011-09-09 03:00:00,0,1,1,1,2
2011-09-09 04:00:00,0,1,0,3,3
2011-09-09 05:00:00,0,1,0,14,14
2011-09-09 06:00:00,0,1,3,54,57
2011-09-09 07:00:00,0,1,4,104,108
2011-09-09 08:00:00,0,1,12,276,288
2011-09-09 09:00:00,0,1,5,131,136
2011-09-09 10:00:00,0,1,2,27,29
2011-09-09 11:00:00,0,1,6,66,72
2011-09-09 12:00:00,0,1,4,71,75
2011-09-09 13:00:00,0,1,14,108,122
2011-09-09 14:00:00,0,1,29,119,148
2011-09-09 15:00:00,0,1,27,161,188
2011-09-09 16:00:00,0,1,41,244,285
2011-09-09 17:00:00,0,1,54,451,505
2011-09-09 18:00:00,0,1,33,377,410
2011-09-09 19:00:00,0,1,33,316,349
2011-09-09 20:00:00,0,1,30,180,210
2011-09-09 21:00:00,0,1,49,154,203
2011-09-09 22:00:00,0,1,33,127,160
2011-09-09 23:00:00,0,1,35,113,148
2011-09-10 00:00:00,0,0,32,84,116
2011-09-10 01:00:00,0,0,16,67,83
2011-09-10 02:00:00,0,0,18,46,64
2011-09-10 03:00:00,0,0,8,29,37
2011-09-10 04:00:00,0,0,3,4,7
2011-09-10 05:00:00,0,0,2,6,8
2011-09-10 06:00:00,0,0,0,6,6
2011-09-10 07:00:00,0,0,9,43,52
2011-09-10 08:00:00,0,0,16,103,119
2011-09-10 09:00:00,0,0,39,168,207
2011-09-10 10:00:00,0,0,85,233,318
2011-09-10 11:00:00,0,0,108,252,360
2011-09-10 12:00:00,0,0,144,260,404
2011-09-10 13:00:00,0,0,131,239,370
2011-09-10 14:00:00,0,0,129,230,359
2011-09-10 15:00:00,0,0,217,263,480
2011-09-10 16:00:00,0,0,170,261,431
2011-09-10 17:00:00,0,0,185,275,460
2011-09-10 18:00:00,0,0,119,241,360
2011-09-10 19:00:00,0,0,101,214,315
2011-09-10 20:00:00,0,0,78,167,245
2011-09-10 21:00:00,0,0,59,171,230
2011-09-10 22:00:00,0,0,49,126,175
2011-09-10 23:00:00,0,0,32,107,139
2011-09-11 00:00:00,0,0,29,79,108
2011-09-11 01:00:00,0,0,22,66,88
2011-09-11 02:00:00,0,0,16,60,76
2011-09-11 03:00:00,0,0,15,30,45
2011-09-11 04:00:00,0,0,3,6,9
2011-09-11 05:00:00,0,0,15,24,39
2011-09-11 06:00:00,0,0,4,16,20
2011-09-11 07:00:00,0,0,9,28,37
2011-09-11 08:00:00,0,0,25,69,94
2011-09-11 09:00:00,0,0,59,168,227
2011-09-11 10:00:00,0,0,120,214,334
2011-09-11 11:00:00,0,0,144,258,402
2011-09-11 12:00:00,0,0,113,298,411
2011-09-11 13:00:00,0,0,119,231,350
2011-09-11 14:00:00,0,0,120,222,342
2011-09-11 15:00:00,0,0,134,270,404
2011-09-11 16:00:00,0,0,180,303,483
2011-09-11 17:00:00,0,0,152,228,380
2011-09-11 18:00:00,0,0,110,229,339
2011-09-11 19:00:00,0,0,101,232,333
2011-09-11 20:00:00,0,0,65,161,226
2011-09-11 21:00:00,0,0,45,114,159
2011-09-11 22:00:00,0,0,21,74,95
2011-09-11 23:00:00,0,0,12,33,45
2011-09-12 00:00:00,0,1,5,11,16
2011-09-12 01:00:00,0,1,1,11,12
2011-09-12 02:00:00,0,1,2,0,2
2011-09-12 04:00:00,0,1,0,4,4
2011-09-12 05:00:00,0,1,1,23,24
2011-09-12 06:00:00,0,1,1,108,109
2011-09-12 07:00:00,0,1,12,300,312
2011-09-12 08:00:00,0,1,26,382,408
2011-09-12 09:00:00,0,1,21,155,176
2011-09-12 10:00:00,0,1,40,89,129
2011-09-12 11:00:00,0,1,34,131,165
2011-09-12 12:00:00,0,1,37,147,184
2011-09-12 13:00:00,0,1,43,120,163
2011-09-12 14:00:00,0,1,60,129,189
2011-09-12 15:00:00,0,1,60,152,212
2011-09-12 16:00:00,0,1,60,238,298
2011-09-12 17:00:00,0,1,75,515,590
2011-09-12 18:00:00,0,1,56,515,571
2011-09-12 19:00:00,0,1,63,373,436
2011-09-12 20:00:00,0,1,41,258,299
2011-09-12 21:00:00,0,1,29,166,195
2011-09-12 22:00:00,0,1,16,134,150
2011-09-12 23:00:00,0,1,7,62,69
2011-09-13 00:00:00,0,1,7,19,26
2011-09-13 01:00:00,0,1,4,6,10
2011-09-13 02:00:00,0,1,2,0,2
2011-09-13 03:00:00,0,1,2,2,4
2011-09-13 04:00:00,0,1,2,6,8
2011-09-13 05:00:00,0,1,1,19,20
2011-09-13 06:00:00,0,1,6,116,122
2011-09-13 07:00:00,0,1,14,348,362
2011-09-13 08:00:00,0,1,26,399,425
2011-09-13 09:00:00,0,1,35,179,214
2011-09-13 10:00:00,0,1,42,93,135
2011-09-13 11:00:00,0,1,33,120,153
2011-09-13 12:00:00,0,1,43,144,187
2011-09-13 13:00:00,0,1,48,136,184
2011-09-13 14:00:00,0,1,51,139,190
2011-09-13 15:00:00,0,1,35,145,180
2011-09-13 16:00:00,0,1,41,251,292
2011-09-13 17:00:00,0,1,72,507,579
2011-09-13 18:00:00,0,1,67,472,539
2011-09-13 19:00:00,0,1,55,341,396
2011-09-13 20:00:00,0,1,31,241,272
2011-09-13 21:00:00,0,1,45,200,245
2011-09-13 22:00:00,0,1,24,120,144
2011-09-13 23:00:00,0,1,15,59,74
2011-09-14 00:00:00,0,1,5,28,33
2011-09-14 01:00:00,0,1,1,7,8
2011-09-14 02:00:00,0,1,1,4,5
2011-09-14 03:00:00,0,1,1,7,8
2011-09-14 04:00:00,0,1,1,8,9
2011-09-14 05:00:00,0,1,1,30,31
2011-09-14 06:00:00,0,1,7,138,145
2011-09-14 07:00:00,0,1,20,350,370
2011-09-14 08:00:00,0,1,33,396,429
2011-09-14 09:00:00,0,1,19,183,202
2011-09-14 10:00:00,0,1,27,115,142
2011-09-14 11:00:00,0,1,43,121,164
2011-09-14 12:00:00,0,1,56,156,212
2011-09-14 13:00:00,0,1,39,139,178
2011-09-14 14:00:00,0,1,19,105,124
2011-09-14 15:00:00,0,1,30,146,176
2011-09-14 16:00:00,0,1,36,241,277
2011-09-14 17:00:00,0,1,87,512,599
2011-09-14 18:00:00,0,1,83,503,586
2011-09-14 19:00:00,0,1,44,337,381
2011-09-14 20:00:00,0,1,40,221,261
2011-09-14 21:00:00,0,1,24,189,213
2011-09-14 22:00:00,0,1,20,140,160
2011-09-14 23:00:00,0,1,10,62,72
2011-09-15 00:00:00,0,1,3,34,37
2011-09-15 01:00:00,0,1,0,20,20
2011-09-15 02:00:00,0,1,0,5,5
2011-09-15 03:00:00,0,1,3,5,8
2011-09-15 04:00:00,0,1,2,5,7
2011-09-15 05:00:00,0,1,1,30,31
2011-09-15 06:00:00,0,1,5,119,124
2011-09-15 07:00:00,0,1,17,321,338
2011-09-15 08:00:00,0,1,27,364,391
2011-09-15 09:00:00,0,1,23,186,209
2011-09-15 10:00:00,0,1,25,96,121
2011-09-15 11:00:00,0,1,39,120,159
2011-09-15 12:00:00,0,1,31,148,179
2011-09-15 13:00:00,0,1,38,151,189
2011-09-15 14:00:00,0,1,36,134,170
2011-09-15 15:00:00,0,1,25,110,135
2011-09-15 16:00:00,0,1,29,193,222
2011-09-15 17:00:00,0,1,31,230,261
2011-09-15 18:00:00,0,1,22,222,244
2011-09-15 19:00:00,0,1,20,212,232
2011-09-15 20:00:00,0,1,25,223,248
2011-09-15 21:00:00,0,1,11,134,145
2011-09-15 22:00:00,0,1,7,108,115
2011-09-15 23:00:00,0,1,8,61,69
2011-09-16 00:00:00,0,1,5,43,48
2011-09-16 01:00:00,0,1,7,19,26
2011-09-16 02:00:00,0,1,3,7,10
2011-09-16 03:00:00,0,1,2,4,6
2011-09-16 04:00:00,0,1,1,3,4
2011-09-16 05:00:00,0,1,2,30,32
2011-09-16 06:00:00,0,1,6,87,93
2011-09-16 07:00:00,0,1,16,283,299
2011-09-16 08:00:00,0,1,23,386,409
2011-09-16 09:00:00,0,1,21,189,210
2011-09-16 10:00:00,0,1,36,104,140
2011-09-16 11:00:00,0,1,40,139,179
2011-09-16 12:00:00,0,1,39,212,251
2011-09-16 13:00:00,0,1,55,168,223
2011-09-16 14:00:00,0,1,49,176,225
2011-09-16 15:00:00,0,1,38,165,203
2011-09-16 16:00:00,0,1,67,291,358
2011-09-16 17:00:00,0,1,86,480,566
2011-09-16 18:00:00,0,1,55,427,482
2011-09-16 19:00:00,0,1,59,256,315
2011-09-16 20:00:00,0,1,41,184,225
2011-09-16 21:00:00,0,1,39,124,163
2011-09-16 22:00:00,0,1,32,135,167
2011-09-16 23:00:00,0,1,20,106,126
2011-09-17 00:00:00,0,0,28,80,108
2011-09-17 01:00:00,0,0,28,52,80
2011-09-17 02:00:00,0,0,18,61,79
2011-09-17 03:00:00,0,0,7,21,28
2011-09-17 04:00:00,0,0,1,4,5
2011-09-17 05:00:00,0,0,2,3,5
2011-09-17 06:00:00,0,0,5,17,22
2011-09-17 07:00:00,0,0,4,33,37
2011-09-17 08:00:00,0,0,27,81,108
2011-09-17 09:00:00,0,0,32,145,177
2011-09-17 10:00:00,0,0,72,177,249
2011-09-17 11:00:00,0,0,119,248,367
2011-09-17 12:00:00,0,0,115,257,372
2011-09-17 13:00:00,0,0,124,225,349
2011-09-17 14:00:00,0,0,123,174,297
2011-09-17 15:00:00,0,0,148,206,354
2011-09-17 16:00:00,0,0,116,189,305
2011-09-17 17:00:00,0,0,141,218,359
2011-09-17 18:00:00,0,0,95,234,329
2011-09-17 19:00:00,0,0,70,186,256
2011-09-17 20:00:00,0,0,43,133,176
2011-09-17 21:00:00,0,0,49,121,170
2011-09-17 22:00:00,0,0,31,112,143
2011-09-17 23:00:00,0,0,36,100,136
2011-09-18 00:00:00,0,0,24,88,112
2011-09-18 01:00:00,0,0,13,66,79
2011-09-18 02:00:00,0,0,21,68,89
2011-09-18 03:00:00,0,0,11,25,36
2011-09-18 04:00:00,0,0,1,0,1
2011-09-18 05:00:00,0,0,1,5,6
2011-09-18 06:00:00,0,0,2,10,12
2011-09-18 07:00:00,0,0,15,29,44
2011-09-18 08:00:00,0,0,16,53,69
2011-09-18 09:00:00,0,0,46,94,140
2011-09-18 10:00:00,0,0,82,178,260
2011-09-18 11:00:00,0,0,116,201,317
2011-09-18 12:00:00,0,0,135,229,364
2011-09-18 13:00:00,0,0,162,214,376
2011-09-18 14:00:00,0,0,127,184,311
2011-09-18 15:00:00,0,0,132,233,365
2011-09-18 16:00:00,0,0,134,235,369
2011-09-18 17:00:00,0,0,95,230,325
2011-09-18 18:00:00,0,0,66,223,289
2011-09-18 19:00:00,0,0,54,191,245
2011-09-18 20:00:00,0,0,44,136,180
2011-09-18 21:00:00,0,0,37,110,147
2011-09-18 22:00:00,0,0,9,75,84
2011-09-18 23:00:00,0,0,10,44,54
2011-09-19 00:00:00,0,1,14,23,37
2011-09-19 01:00:00,0,1,3,7,10
2011-09-19 02:00:00,0,1,6,7,13
2011-09-19 03:00:00,0,1,1,4,5
2011-09-19 04:00:00,0,1,2,6,8
2011-09-19 05:00:00,0,1,2,26,28
2011-09-19 06:00:00,0,1,6,107,113
2011-09-19 07:00:00,0,1,20,312,332
2011-09-19 08:00:00,0,1,29,391,420
2011-09-19 09:00:00,0,1,32,183,215
2011-09-19 10:00:00,0,1,21,84,105
2011-09-19 11:00:00,0,1,41,98,139
2011-09-19 12:00:00,0,1,51,138,189
2011-09-19 13:00:00,0,1,53,124,177
2011-09-19 14:00:00,0,1,45,143,188
2011-09-19 15:00:00,0,1,44,143,187
2011-09-19 16:00:00,0,1,55,208,263
2011-09-19 17:00:00,0,1,85,483,568
2011-09-19 18:00:00,0,1,56,484,540
2011-09-19 19:00:00,0,1,41,333,374
2011-09-19 20:00:00,0,1,27,204,231
2011-09-19 21:00:00,0,1,19,181,200
2011-09-19 22:00:00,0,1,25,104,129
2011-09-19 23:00:00,0,1,13,55,68
2011-10-01 00:00:00,0,0,24,106,130
2011-10-01 01:00:00,0,0,11,47,58
2011-10-01 02:00:00,0,0,21,46,67
2011-10-01 03:00:00,0,0,8,17,25
2011-10-01 04:00:00,0,0,2,6,8
2011-10-01 05:00:00,0,0,1,4,5
2011-10-01 06:00:00,0,0,4,15,19
2011-10-01 07:00:00,0,0,6,30,36
2011-10-01 08:00:00,0,0,9,58,67
2011-10-01 09:00:00,0,0,17,112,129
2011-10-01 10:00:00,0,0,21,100,121
2011-10-01 11:00:00,0,0,30,102,132
2011-10-01 12:00:00,0,0,28,130,158
2011-10-01 13:00:00,0,0,27,98,125
2011-10-01 14:00:00,0,0,33,147,180
2011-10-01 15:00:00,0,0,41,154,195
2011-10-01 16:00:00,0,0,58,165,223
2011-10-01 17:00:00,0,0,58,170,228
2011-10-01 18:00:00,0,0,23,117,140
2011-10-01 19:00:00,0,0,27,99,126
2011-10-01 20:00:00,0,0,8,58,66
2011-10-01 21:00:00,0,0,3,53,56
2011-10-01 22:00:00,0,0,12,58,70
2011-10-01 23:00:00,0,0,8,57,65
2011-10-02 00:00:00,0,0,4,43,47
2011-10-02 01:00:00,0,0,1,23,24
2011-10-02 02:00:00,0,0,3,27,30
2011-10-02 03:00:00,0,0,4,5,9
2011-10-02 04:00:00,0,0,4,3,7
2011-10-02 05:00:00,0,0,0,7,7
2011-10-02 06:00:00,0,0,2,13,15
2011-10-02 07:00:00,0,0,5,24,29
2011-10-02 08:00:00,0,0,14,50,64
2011-10-02 09:00:00,0,0,19,96,115
2011-10-02 10:00:00,0,0,60,188,248
2011-10-02 11:00:00,0,0,74,218,292
2011-10-02 12:00:00,0,0,78,243,321
2011-10-02 13:00:00,0,0,84,224,308
2011-10-02 14:00:00,0,0,61,195,256
2011-10-02 15:00:00,0,0,29,144,173
2011-10-02 16:00:00,0,0,44,162,206
2011-10-02 17:00:00,0,0,32,135,167
2011-10-02 18:00:00,0,0,16,158,174
2011-10-02 19:00:00,0,0,34,128,162
2011-10-02 20:00:00,0,0,16,71,87
2011-10-02 21:00:00,0,0,17,71,88
2011-10-02 22:00:00,0,0,9,55,64
2011-10-02 23:00:00,0,0,6,19,25
2011-10-03 00:00:00,0,1,3,13,16
2011-10-03 01:00:00,0,1,1,5,6
2011-10-03 02:00:00,0,1,0,4,4
2011-10-03 03:00:00,0,1,1,6,7
2011-10-03 04:00:00,0,1,2,6,8
2011-10-03 05:00:00,0,1,4,17,21
2011-10-03 06:00:00,0,1,3,91,94
2011-10-03 07:00:00,0,1,8,241,249
2011-10-03 08:00:00,0,1,13,359,372
2011-10-03 09:00:00,0,1,12,141,153
2011-10-03 10:00:00,0,1,19,82,101
2011-10-03 11:00:00,0,1,26,100,126
2011-10-03 12:00:00,0,1,29,118,147
2011-10-03 13:00:00,0,1,16,102,118
2011-10-03 14:00:00,0,1,26,94,120
2011-10-03 15:00:00,0,1,22,79,101
2011-10-03 16:00:00,0,1,16,202,218
2011-10-03 17:00:00,0,1,40,455,495
2011-10-03 18:00:00,0,1,28,384,412
2011-10-03 19:00:00,0,1,15,300,315
2011-10-03 20:00:00,0,1,13,191,204
2011-10-03 21:00:00,0,1,10,128,138
2011-10-03 22:00:00,0,1,12,79,91
2011-10-03 23:00:00,0,1,11,43,54
2011-10-04 00:00:00,0,1,5,22,27
2011-10-04 01:00:00,0,1,1,8,9
2011-10-04 02:00:00,0,1,1,2,3
2011-10-04 03:00:00,0,1,3,3,6
2011-10-04 04:00:00,0,1,3,4,7
2011-10-04 05:00:00,0,1,2,25,27
2011-10-04 06:00:00,0,1,3,109,112
2011-10-04 07:00:00,0,1,11,298,309
2011-10-04 08:00:00,0,1,28,372,400
2011-10-04 09:00:00,0,1,19,168,187
2011-10-04 10:00:00,0,1,19,107,126
2011-10-04 11:00:00,0,1,22,102,124
2011-10-04 12:00:00,0,1,39,160,199
2011-10-04 13:00:00,0,1,20,153,173
2011-10-04 14:00:00,0,1,27,156,183
2011-10-04 15:00:00,0,1,28,166,194
2011-10-04 16:00:00,0,1,36,273,309
2011-10-04 17:00:00,0,1,55,530,585
2011-10-04 18:00:00,0,1,68,456,524
2011-10-04 19:00:00,0,1,35,310,345
2011-10-04 20:00:00,0,1,25,236,261
2011-10-04 21:00:00,0,1,22,144,166
2011-10-04 22:00:00,0,1,8,106,114
2011-10-04 23:00:00,0,1,6,60,66
2011-10-05 00:00:00,0,1,7,36,43
2011-10-05 01:00:00,0,1,4,7,11
2011-10-05 02:00:00,0,1,1,2,3
2011-10-05 03:00:00,0,1,1,5,6
2011-10-05 04:00:00,0,1,1,4,5
2011-10-05 05:00:00,0,1,3,29,32
2011-10-05 06:00:00,0,1,5,112,117
2011-10-05 07:00:00,0,1,9,292,301
2011-10-05 08:00:00,0,1,26,441,467
2011-10-05 09:00:00,0,1,32,187,219
2011-10-05 10:00:00,0,1,30,103,133
2011-10-05 11:00:00,0,1,32,138,170
2011-10-05 12:00:00,0,1,34,180,214
2011-10-05 13:00:00,0,1,30,189,219
2011-10-05 14:00:00,0,1,34,156,190
2011-10-05 15:00:00,0,1,35,147,182
2011-10-05 16:00:00,0,1,37,245,282
2011-10-05 17:00:00,0,1,66,525,591
2011-10-05 18:00:00,0,1,57,536,593
2011-10-05 19:00:00,0,1,40,334,374
2011-10-05 20:00:00,0,1,18,228,246
2011-10-05 21:00:00,0,1,28,173,201
2011-10-05 22:00:00,0,1,20,134,154
2011-10-05 23:00:00,0,1,9,64,73
2011-10-06 00:00:00,0,1,6,34,40
2011-10-06 01:00:00,0,1,5,17,22
2011-10-06 02:00:00,0,1,2,8,10
2011-10-06 03:00:00,0,1,1,4,5
2011-10-06 04:00:00,0,1,0,5,5
2011-10-06 05:00:00,0,1,0,24,24
2011-10-06 06:00:00,0,1,4,110,114
2011-10-06 07:00:00,0,1,15,287,302
2011-10-06 08:00:00,0,1,20,437,457
2011-10-06 09:00:00,0,1,20,188,208
2011-10-06 10:00:00,0,1,24,105,129
2011-10-06 11:00:00,0,1,29,115,144
2011-10-06 12:00:00,0,1,46,180,226
2011-10-06 13:00:00,0,1,33,158,191
2011-10-06 14:00:00,0,1,56,139,195
2011-10-06 15:00:00,0,1,62,157,219
2011-10-06 16:00:00,0,1,51,272,323
2011-10-06 17:00:00,0,1,63,505,568
2011-10-06 18:00:00,0,1,59,479,538
2011-10-06 19:00:00,0,1,38,305,343
2011-10-06 20:00:00,0,1,29,231,260
2011-10-06 21:00:00,0,1,34,161,195
2011-10-06 22:00:00,0,1,24,124,148
2011-10-06 23:00:00,0,1,18,81,99
2011-10-07 00:00:00,0,1,19,48,67
2011-10-07 01:00:00,0,1,3,25,28
2011-10-07 02:00:00,0,1,0,5,5
2011-10-07 03:00:00,0,1,1,9,10
2011-10-07 04:00:00,0,1,0,5,5
2011-10-07 05:00:00,0,1,3,24,27
2011-10-07 06:00:00,0,1,3,84,87
2011-10-07 07:00:00,0,1,5,237,242
2011-10-07 08:00:00,0,1,31,386,417
2011-10-07 09:00:00,0,1,34,207,241
2011-10-07 10:00:00,0,1,48,126,174
2011-10-07 11:00:00,0,1,80,150,230
2011-10-07 12:00:00,0,1,61,174,235
2011-10-07 13:00:00,0,1,95,210,305
2011-10-07 14:00:00,0,1,77,179,256
2011-10-07 15:00:00,0,1,68,202,270
2011-10-07 16:00:00,0,1,73,346,419
2011-10-07 17:00:00,0,1,101,462,563
2011-10-07 18:00:00,0,1,94,371,465
2011-10-07 19:00:00,0,1,51,243,294
2011-10-07 20:00:00,0,1,30,167,197
2011-10-07 21:00:00,0,1,22,144,166
2011-10-07 22:00:00,0,1,27,119,146
2011-10-07 23:00:00,0,1,23,113,136
2011-10-08 00:00:00,0,0,17,72,89
2011-10-08 01:00:00,0,0,14,51,65
2011-10-08 02:00:00,0,0,4,41,45
2011-10-08 03:00:00,0,0,4,16,20
2011-10-08 04:00:00,0,0,3,7,10
2011-10-08 05:00:00,0,0,1,7,8
2011-10-08 06:00:00,0,0,6,16,22
2011-10-08 07:00:00,0,0,27,46,73
2011-10-08 08:00:00,0,0,14,89,103
2011-10-08 09:00:00,0,0,54,163,217
2011-10-08 10:00:00,0,0,120,217,337
2011-10-08 11:00:00,0,0,176,221,397
2011-10-08 12:00:00,0,0,191,255,446
2011-10-08 13:00:00,0,0,256,229,485
2011-10-08 14:00:00,0,0,251,214,465
2011-10-08 15:00:00,0,0,262,234,496
2011-10-08 16:00:00,0,0,221,230,451
2011-10-08 17:00:00,0,0,174,219,393
2011-10-08 18:00:00,0,0,135,224,359
2011-10-08 19:00:00,0,0,76,172,248
2011-10-08 20:00:00,0,0,78,124,202
2011-10-08 21:00:00,0,0,54,133,187
2011-10-08 22:00:00,0,0,45,104,149
2011-10-08 23:00:00,0,0,52,90,142
2011-10-09 00:00:00,0,0,46,83,129
2011-10-09 01:00:00,0,0,15,63,78
2011-10-09 02:00:00,0,0,20,35,55
2011-10-09 03:00:00,0,0,10,20,30
2011-10-09 04:00:00,0,0,7,7,14
2011-10-09 05:00:00,0,0,1,14,15
2011-10-09 06:00:00,0,0,7,14,21
2011-10-09 07:00:00,0,0,18,26,44
2011-10-09 08:00:00,0,0,25,82,107
2011-10-09 09:00:00,0,0,66,119,185
2011-10-09 10:00:00,0,0,155,210,365
2011-10-09 11:00:00,0,0,189,234,423
2011-10-09 12:00:00,0,0,212,243,455
2011-10-09 13:00:00,0,0,225,193,418
2011-10-09 14:00:00,0,0,272,228,500
2011-10-09 15:00:00,0,0,198,209,407
2011-10-09 16:00:00,0,0,223,247,470
2011-10-09 17:00:00,0,0,208,230,438
2011-10-09 18:00:00,0,0,186,228,414
2011-10-09 19:00:00,0,0,116,186,302
2011-10-09 20:00:00,0,0,59,134,193
2011-10-09 21:00:00,0,0,53,120,173
2011-10-09 22:00:00,0,0,48,104,152
2011-10-09 23:00:00,0,0,38,85,123
2011-10-10 00:00:00,1,0,11,42,53
2011-10-10 01:00:00,1,0,4,30,34
2011-10-10 02:00:00,1,0,4,15,19
2011-10-10 03:00:00,1,0,2,9,11
2011-10-10 04:00:00,1,0,2,4,6
2011-10-10 05:00:00,1,0,2,19,21
2011-10-10 06:00:00,1,0,5,39,44
2011-10-10 07:00:00,1,0,12,102,114
2011-10-10 08:00:00,1,0,27,227,254
2011-10-10 09:00:00,1,0,58,161,219
2011-10-10 10:00:00,1,0,107,158,265
2011-10-10 11:00:00,1,0,139,183,322
2011-10-10 12:00:00,1,0,164,201,365
2011-10-10 13:00:00,1,0,146,219,365
2011-10-10 14:00:00,1,0,147,223,370
2011-10-10 15:00:00,1,0,130,254,384
2011-10-10 16:00:00,1,0,154,248,402
2011-10-10 17:00:00,1,0,125,334,459
2011-10-10 18:00:00,1,0,108,365,473
2011-10-10 19:00:00,1,0,69,267,336
2011-10-10 20:00:00,1,0,37,188,225
2011-10-10 21:00:00,1,0,27,148,175
2011-10-10 22:00:00,1,0,22,104,126
2011-10-10 23:00:00,1,0,12,63,75
2011-10-11 00:00:00,0,1,14,16,30
2011-10-11 01:00:00,0,1,2,9,11
2011-10-11 02:00:00,0,1,1,4,5
2011-10-11 03:00:00,0,1,2,1,3
2011-10-11 04:00:00,0,1,0,5,5
2011-10-11 05:00:00,0,1,0,20,20
2011-10-11 06:00:00,0,1,9,114,123
2011-10-11 07:00:00,0,1,19,333,352
2011-10-11 08:00:00,0,1,31,375,406
2011-10-11 09:00:00,0,1,40,195,235
2011-10-11 10:00:00,0,1,38,111,149
2011-10-11 11:00:00,0,1,31,92,123
2011-10-11 12:00:00,0,1,51,130,181
2011-10-11 13:00:00,0,1,42,138,180
2011-10-11 14:00:00,0,1,54,117,171
2011-10-11 15:00:00,0,1,36,139,175
2011-10-11 16:00:00,0,1,63,257,320
2011-10-11 17:00:00,0,1,70,534,604
2011-10-11 18:00:00,0,1,46,493,539
2011-10-11 19:00:00,0,1,33,285,318
2011-10-11 20:00:00,0,1,31,203,234
2011-10-11 21:00:00,0,1,17,158,175
2011-10-11 22:00:00,0,1,27,120,147
2011-10-11 23:00:00,0,1,10,47,57
2011-10-12 00:00:00,0,1,2,23,25
2011-10-12 01:00:00,0,1,2,8,10
2011-10-12 02:00:00,0,1,0,2,2
2011-10-12 03:00:00,0,1,0,2,2
2011-10-12 04:00:00,0,1,1,6,7
2011-10-12 05:00:00,0,1,0,22,22
2011-10-12 06:00:00,0,1,5,107,112
2011-10-12 07:00:00,0,1,15,244,259
2011-10-12 08:00:00,0,1,27,377,404
2011-10-12 09:00:00,0,1,14,183,197
2011-10-12 10:00:00,0,1,15,98,113
2011-10-12 11:00:00,0,1,18,102,120
2011-10-12 12:00:00,0,1,9,53,62
2011-10-12 13:00:00,0,1,25,76,101
2011-10-12 14:00:00,0,1,8,70,78
2011-10-12 15:00:00,0,1,3,42,45
2011-10-12 16:00:00,0,1,5,50,55
2011-10-12 17:00:00,0,1,16,235,251
2011-10-12 18:00:00,0,1,11,161,172
2011-10-12 19:00:00,0,1,7,102,109
2011-10-12 20:00:00,0,1,9,81,90
2011-10-12 21:00:00,0,1,9,74,83
2011-10-12 22:00:00,0,1,3,40,43
2011-10-12 23:00:00,0,1,13,41,54
2011-10-13 00:00:00,0,1,1,14,15
2011-10-13 01:00:00,0,1,3,9,12
2011-10-13 02:00:00,0,1,0,4,4
2011-10-13 03:00:00,0,1,2,4,6
2011-10-13 04:00:00,0,1,2,5,7
2011-10-13 05:00:00,0,1,1,16,17
2011-10-13 06:00:00,0,1,1,51,52
2011-10-13 07:00:00,0,1,5,76,81
2011-10-13 08:00:00,0,1,10,199,209
2011-10-13 09:00:00,0,1,3,106,109
2011-10-13 10:00:00,0,1,16,53,69
2011-10-13 11:00:00,0,1,8,76,84
2011-10-13 12:00:00,0,1,10,95,105
2011-10-13 13:00:00,0,1,20,142,162
2011-10-13 14:00:00,0,1,22,111,133
2011-10-13 15:00:00,0,1,27,128,155
2011-10-13 16:00:00,0,1,36,240,276
2011-10-13 17:00:00,0,1,47,432,479
2011-10-13 18:00:00,0,1,20,248,268
2011-10-13 19:00:00,0,1,18,187,205
2011-10-13 20:00:00,0,1,15,166,181
2011-10-13 21:00:00,0,1,8,115,123
2011-10-13 22:00:00,0,1,13,101,114
2011-10-13 23:00:00,0,1,2,45,47
2011-10-14 00:00:00,0,1,10,29,39
2011-10-14 01:00:00,0,1,8,16,24
2011-10-14 02:00:00,0,1,0,6,6
2011-10-14 03:00:00,0,1,1,6,7
2011-10-14 04:00:00,0,1,0,8,8
2011-10-14 05:00:00,0,1,0,17,17
2011-10-14 06:00:00,0,1,4,90,94
2011-10-14 07:00:00,0,1,10,137,147
2011-10-14 08:00:00,0,1,23,186,209
2011-10-14 09:00:00,0,1,16,164,180
2011-10-14 10:00:00,0,1,17,108,125
2011-10-14 11:00:00,0,1,11,76,87
2011-10-14 12:00:00,0,1,13,62,75
2011-10-14 13:00:00,0,1,18,114,132
2011-10-14 14:00:00,0,1,37,119,156
2011-10-14 15:00:00,0,1,61,169,230
2011-10-14 16:00:00,0,1,80,264,344
2011-10-14 17:00:00,0,1,55,426,481
2011-10-14 18:00:00,0,1,62,361,423
2011-10-14 19:00:00,0,1,27,221,248
2011-10-14 20:00:00,0,1,19,177,196
2011-10-14 21:00:00,0,1,22,156,178
2011-10-14 22:00:00,0,1,20,123,143
2011-10-14 23:00:00,0,1,15,80,95
2011-10-15 00:00:00,0,0,18,88,106
2011-10-15 01:00:00,0,0,9,64,73
2011-10-15 02:00:00,0,0,17,39,56
2011-10-15 03:00:00,0,0,5,18,23
2011-10-15 04:00:00,0,0,0,6,6
2011-10-15 05:00:00,0,0,1,6,7
2011-10-15 06:00:00,0,0,5,15,20
2011-10-15 07:00:00,0,0,17,40,57
2011-10-15 08:00:00,0,0,24,101,125
2011-10-15 09:00:00,0,0,50,157,207
2011-10-15 10:00:00,0,0,115,207,322
2011-10-15 11:00:00,0,0,153,221,374
2011-10-15 12:00:00,0,0,195,261,456
2011-10-15 13:00:00,0,0,171,223,394
2011-10-15 14:00:00,0,0,242,230,472
2011-10-15 15:00:00,0,0,166,211,377
2011-10-15 16:00:00,0,0,179,264,443
2011-10-15 17:00:00,0,0,177,264,441
2011-10-15 18:00:00,0,0,121,251,372
2011-10-15 19:00:00,0,0,61,177,238
2011-10-15 20:00:00,0,0,42,137,179
2011-10-15 21:00:00,0,0,53,115,168
2011-10-15 22:00:00,0,0,45,121,166
2011-10-15 23:00:00,0,0,33,102,135
2011-10-16 00:00:00,0,0,22,85,107
2011-10-16 01:00:00,0,0,13,64,77
2011-10-16 02:00:00,0,0,13,52,65
2011-10-16 03:00:00,0,0,11,31,42
2011-10-16 04:00:00,0,0,5,7,12
2011-10-16 05:00:00,0,0,1,6,7
2011-10-16 06:00:00,0,0,3,7,10
2011-10-16 07:00:00,0,0,9,39,48
2011-10-16 08:00:00,0,0,28,71,99
2011-10-16 09:00:00,0,0,39,151,190
2011-10-16 10:00:00,0,0,121,226,347
2011-10-16 11:00:00,0,0,159,218,377
2011-10-16 12:00:00,0,0,167,277,444
2011-10-16 13:00:00,0,0,169,269,438
2011-10-16 14:00:00,0,0,204,258,462
2011-10-16 15:00:00,0,0,182,230,412
2011-10-16 16:00:00,0,0,177,289,466
2011-10-16 17:00:00,0,0,152,253,405
2011-10-16 18:00:00,0,0,102,226,328
2011-10-16 19:00:00,0,0,52,181,233
2011-10-16 20:00:00,0,0,49,129,178
2011-10-16 21:00:00,0,0,14,88,102
2011-10-16 22:00:00,0,0,42,88,130
2011-10-16 23:00:00,0,0,14,48,62
2011-10-17 00:00:00,0,1,12,25,37
2011-10-17 01:00:00,0,1,2,15,17
2011-10-17 02:00:00,0,1,4,3,7
2011-10-17 03:00:00,0,1,0,2,2
2011-10-17 04:00:00,0,1,2,3,5
2011-10-17 05:00:00,0,1,1,28,29
2011-10-17 06:00:00,0,1,7,107,114
2011-10-17 07:00:00,0,1,10,299,309
2011-10-17 08:00:00,0,1,33,381,414
2011-10-17 09:00:00,0,1,26,180,206
2011-10-17 10:00:00,0,1,43,92,135
2011-10-17 11:00:00,0,1,35,131,166
2011-10-17 12:00:00,0,1,39,166,205
2011-10-17 13:00:00,0,1,49,156,205
2011-10-17 14:00:00,0,1,44,122,166
2011-10-17 15:00:00,0,1,66,142,208
2011-10-17 16:00:00,0,1,64,238,302
2011-10-17 17:00:00,0,1,80,540,620
2011-10-17 18:00:00,0,1,49,469,518
2011-10-17 19:00:00,0,1,45,288,333
2011-10-17 20:00:00,0,1,40,189,229
2011-10-17 21:00:00,0,1,36,141,177
2011-10-17 22:00:00,0,1,16,88,104
2011-10-17 23:00:00,0,1,10,52,62
2011-10-18 00:00:00,0,1,8,23,31
2011-10-18 01:00:00,0,1,4,7,11
2011-10-18 02:00:00,0,1,1,4,5
2011-10-18 03:00:00,0,1,0,1,1
2011-10-18 04:00:00,0,1,0,4,4
2011-10-18 05:00:00,0,1,2,19,21
2011-10-18 06:00:00,0,1,4,105,109
2011-10-18 07:00:00,0,1,15,326,341
2011-10-18 08:00:00,0,1,25,474,499
2011-10-18 09:00:00,0,1,29,198,227
2011-10-18 10:00:00,0,1,27,75,102
2011-10-18 11:00:00,0,1,35,112,147
2011-10-18 12:00:00,0,1,42,159,201
2011-10-18 13:00:00,0,1,48,171,219
2011-10-18 14:00:00,0,1,32,137,169
2011-10-18 15:00:00,0,1,66,139,205
2011-10-18 16:00:00,0,1,58,246,304
2011-10-18 17:00:00,0,1,72,553,625
2011-10-18 18:00:00,0,1,58,512,570
2011-10-18 19:00:00,0,1,31,286,317
2011-10-18 20:00:00,0,1,23,204,227
2011-10-18 21:00:00,0,1,28,178,206
2011-10-18 22:00:00,0,1,22,115,137
2011-10-18 23:00:00,0,1,7,63,70
2011-10-19 00:00:00,0,1,11,23,34
2011-10-19 01:00:00,0,1,7,9,16
2011-10-19 02:00:00,0,1,1,6,7
2011-10-19 04:00:00,0,1,0,3,3
2011-10-19 05:00:00,0,1,0,3,3
2011-10-19 06:00:00,0,1,3,28,31
2011-10-19 07:00:00,0,1,1,67,68
2011-10-19 08:00:00,0,1,10,200,210
2011-10-19 09:00:00,0,1,17,185,202
2011-10-19 10:00:00,0,1,14,109,123
2011-10-19 11:00:00,0,1,33,116,149
2011-10-19 12:00:00,0,1,13,117,130
2011-10-19 13:00:00,0,1,20,86,106
2011-10-19 14:00:00,0,1,17,80,97
2011-10-19 15:00:00,0,1,21,99,120
2011-10-19 16:00:00,0,1,21,180,201
2011-10-19 17:00:00,0,1,11,170,181
2011-10-19 18:00:00,0,1,8,132,140
2011-10-19 19:00:00,0,1,8,189,197
2011-10-19 20:00:00,0,1,5,140,145
2011-10-19 21:00:00,0,1,6,79,85
2011-10-19 22:00:00,0,1,13,94,107
2011-10-19 23:00:00,0,1,14,55,69
2011-11-01 00:00:00,0,1,3,18,21
2011-11-01 01:00:00,0,1,3,8,11
2011-11-01 02:00:00,0,1,1,3,4
2011-11-01 03:00:00,0,1,1,5,6
2011-11-01 04:00:00,0,1,1,7,8
2011-11-01 05:00:00,0,1,0,18,18
2011-11-01 06:00:00,0,1,3,90,93
2011-11-01 07:00:00,0,1,8,246,254
2011-11-01 08:00:00,0,1,17,402,419
2011-11-01 09:00:00,0,1,16,206,222
2011-11-01 10:00:00,0,1,21,114,135
2011-11-01 11:00:00,0,1,16,101,117
2011-11-01 12:00:00,0,1,23,153,176
2011-11-01 13:00:00,0,1,20,147,167
2011-11-01 14:00:00,0,1,32,118,150
2011-11-01 15:00:00,0,1,38,148,186
2011-11-01 16:00:00,0,1,46,252,298
2011-11-01 17:00:00,0,1,36,470,506
2011-11-01 18:00:00,0,1,39,421,460
2011-11-01 19:00:00,0,1,39,274,313
2011-11-01 20:00:00,0,1,18,191,209
2011-11-01 21:00:00,0,1,13,114,127
2011-11-01 22:00:00,0,1,5,91,96
2011-11-01 23:00:00,0,1,11,61,72
2011-11-02 00:00:00,0,1,0,19,19
2011-11-02 01:00:00,0,1,2,8,10
2011-11-02 02:00:00,0,1,0,2,2
2011-11-02 03:00:00,0,1,0,2,2
2011-11-02 04:00:00,0,1,0,4,4
2011-11-02 05:00:00,0,1,0,27,27
2011-11-02 06:00:00,0,1,1,91,92
2011-11-02 07:00:00,0,1,11,240,251
2011-11-02 08:00:00,0,1,20,452,472
2011-11-02 09:00:00,0,1,15,213,228
2011-11-02 10:00:00,0,1,25,108,133
2011-11-02 11:00:00,0,1,27,117,144
2011-11-02 12:00:00,0,1,32,157,189
2011-11-02 13:00:00,0,1,22,139,161
2011-11-02 14:00:00,0,1,40,132,172
2011-11-02 15:00:00,0,1,26,161,187
2011-11-02 16:00:00,0,1,35,231,266
2011-11-02 17:00:00,0,1,30,523,553
2011-11-02 18:00:00,0,1,31,448,479
2011-11-02 19:00:00,0,1,25,257,282
2011-11-02 20:00:00,0,1,5,177,182
2011-11-02 21:00:00,0,1,13,155,168
2011-11-02 22:00:00,0,1,7,99,106
2011-11-02 23:00:00,0,1,3,54,57
2011-11-03 00:00:00,0,1,3,28,31
2011-11-03 01:00:00,0,1,3,12,15
2011-11-03 02:00:00,0,1,2,5,7
2011-11-03 03:00:00,0,1,1,4,5
2011-11-03 04:00:00,0,1,1,3,4
2011-11-03 05:00:00,0,1,1,27,28
2011-11-03 06:00:00,0,1,3,96,99
2011-11-03 07:00:00,0,1,12,280,292
2011-11-03 08:00:00,0,1,8,394,402
2011-11-03 09:00:00,0,1,9,155,164
2011-11-03 10:00:00,0,1,12,98,110
2011-11-03 11:00:00,0,1,12,108,120
2011-11-03 12:00:00,0,1,17,162,179
2011-11-03 13:00:00,0,1,19,150,169
2011-11-03 14:00:00,0,1,32,120,152
2011-11-03 15:00:00,0,1,24,138,162
2011-11-03 16:00:00,0,1,33,234,267
2011-11-03 17:00:00,0,1,33,465,498
2011-11-03 18:00:00,0,1,24,409,433
2011-11-03 19:00:00,0,1,18,234,252
2011-11-03 20:00:00,0,1,11,198,209
2011-11-03 21:00:00,0,1,4,140,144
2011-11-03 22:00:00,0,1,21,116,137
2011-11-03 23:00:00,0,1,15,80,95
2011-11-04 00:00:00,0,1,11,32,43
2011-11-04 01:00:00,0,1,1,16,17
2011-11-04 02:00:00,0,1,2,8,10
2011-11-04 03:00:00,0,1,1,7,8
2011-11-04 04:00:00,0,1,1,6,7
2011-11-04 05:00:00,0,1,0,23,23
2011-11-04 06:00:00,0,1,2,64,66
2011-11-04 07:00:00,0,1,10,235,245
2011-11-04 08:00:00,0,1,8,387,395
2011-11-04 09:00:00,0,1,15,239,254
2011-11-04 10:00:00,0,1,19,115,134
2011-11-04 11:00:00,0,1,34,128,162
2011-11-04 12:00:00,0,1,44,153,197
2011-11-04 13:00:00,0,1,33,161,194
2011-11-04 14:00:00,0,1,54,147,201
2011-11-04 15:00:00,0,1,45,192,237
2011-11-04 16:00:00,0,1,53,237,290
2011-11-04 17:00:00,0,1,42,438,480
2011-11-04 18:00:00,0,1,35,339,374
2011-11-04 19:00:00,0,1,14,182,196
2011-11-04 20:00:00,0,1,15,171,186
2011-11-04 21:00:00,0,1,8,115,123
2011-11-04 22:00:00,0,1,6,109,115
2011-11-04 23:00:00,0,1,17,72,89
2011-11-05 00:00:00,0,0,4,48,52
2011-11-05 01:00:00,0,0,5,57,62
2011-11-05 02:00:00,0,0,7,24,31
2011-11-05 03:00:00,0,0,0,8,8
2011-11-05 04:00:00,0,0,3,5,8
2011-11-05 05:00:00,0,0,0,2,2
2011-11-05 06:00:00,0,0,3,20,23
2011-11-05 07:00:00,0,0,3,31,34
2011-11-05 08:00:00,0,0,4,80,84
2011-11-05 09:00:00,0,0,30,111,141
2011-11-05 10:00:00,0,0,56,171,227
2011-11-05 11:00:00,0,0,69,169,238
2011-11-05 12:00:00,0,0,137,235,372
2011-11-05 13:00:00,0,0,148,207,355
2011-11-05 14:00:00,0,0,159,227,386
2011-11-05 15:00:00,0,0,141,202,343
2011-11-05 16:00:00,0,0,128,207,335
2011-11-05 17:00:00,0,0,100,234,334
2011-11-05 18:00:00,0,0,52,185,237
2011-11-05 19:00:00,0,0,45,159,204
2011-11-05 20:00:00,0,0,29,136,165
2011-11-05 21:00:00,0,0,19,99,118
2011-11-05 22:00:00,0,0,10,72,82
2011-11-05 23:00:00,0,0,4,81,85
2011-11-06 00:00:00,0,0,10,65,75
2011-11-06 01:00:00,0,0,11,104,115
2011-11-06 02:00:00,0,0,6,23,29
2011-11-06 03:00:00,0,0,5,4,9
2011-11-06 04:00:00,0,0,0,6,6
2011-11-06 05:00:00,0,0,0,5,5
2011-11-06 06:00:00,0,0,5,11,16
2011-11-06 07:00:00,0,0,4,24,28
2011-11-06 08:00:00,0,0,19,71,90
2011-11-06 09:00:00,0,0,36,134,170
2011-11-06 10:00:00,0,0,76,186,262
2011-11-06 11:00:00,0,0,104,216,320
2011-11-06 12:00:00,0,0,120,226,346
2011-11-06 13:00:00,0,0,105,209,314
2011-11-06 14:00:00,0,0,101,219,320
2011-11-06 15:00:00,0,0,96,210,306
2011-11-06 16:00:00,0,0,84,263,347
2011-11-06 17:00:00,0,0,71,185,256
2011-11-06 18:00:00,0,0,39,146,185
2011-11-06 19:00:00,0,0,21,130,151
2011-11-06 20:00:00,0,0,16,100,116
2011-11-06 21:00:00,0,0,11,77,88
2011-11-06 22:00:00,0,0,5,40,45
2011-11-06 23:00:00,0,0,7,43,50
2011-11-07 00:00:00,0,1,1,14,15
2011-11-07 01:00:00,0,1,2,6,8
2011-11-07 02:00:00,0,1,0,2,2
2011-11-07 03:00:00,0,1,0,3,3
2011-11-07 04:00:00,0,1,2,4,6
2011-11-07 05:00:00,0,1,1,25,26
2011-11-07 06:00:00,0,1,2,97,99
2011-11-07 07:00:00,0,1,6,305,311
2011-11-07 08:00:00,0,1,13,397,410
2011-11-07 09:00:00,0,1,18,156,174
2011-11-07 10:00:00,0,1,28,95,123
2011-11-07 11:00:00,0,1,28,100,128
2011-11-07 12:00:00,0,1,21,158,179
2011-11-07 13:00:00,0,1,32,157,189
2011-11-07 14:00:00,0,1,30,115,145
2011-11-07 15:00:00,0,1,38,132,170
2011-11-07 16:00:00,0,1,40,255,295
2011-11-07 17:00:00,0,1,39,489,528
2011-11-07 18:00:00,0,1,18,407,425
2011-11-07 19:00:00,0,1,20,280,300
2011-11-07 20:00:00,0,1,17,187,204
2011-11-07 21:00:00,0,1,10,129,139
2011-11-07 22:00:00,0,1,6,102,108
2011-11-07 23:00:00,0,1,1,47,48
2011-11-08 00:00:00,0,1,0,18,18
2011-11-08 01:00:00,0,1,3,8,11
2011-11-08 02:00:00,0,1,0,1,1
2011-11-08 03:00:00,0,1,0,3,3
2011-11-08 04:00:00,0,1,0,4,4
2011-11-08 05:00:00,0,1,1,17,18
2011-11-08 06:00:00,0,1,3,96,99
2011-11-08 07:00:00,0,1,7,316,323
2011-11-08 08:00:00,0,1,11,455,466
2011-11-08 09:00:00,0,1,14,177,191
2011-11-08 10:00:00,0,1,25,104,129
2011-11-08 11:00:00,0,1,21,126,147
2011-11-08 12:00:00,0,1,28,175,203
2011-11-08 13:00:00,0,1,31,165,196
2011-11-08 14:00:00,0,1,32,129,161
2011-11-08 15:00:00,0,1,33,155,188
2011-11-08 16:00:00,0,1,39,250,289
2011-11-08 17:00:00,0,1,40,459,499
2011-11-08 18:00:00,0,1,30,432,462
2011-11-08 19:00:00,0,1,14,264,278
2011-11-08 20:00:00,0,1,12,169,181
2011-11-08 21:00:00,0,1,16,166,182
2011-11-08 22:00:00,0,1,13,95,108
2011-11-08 23:00:00,0,1,3,45,48
2011-11-09 00:00:00,0,1,0,13,13
2011-11-09 01:00:00,0,1,0,10,10
2011-11-09 02:00:00,0,1,0,5,5
2011-11-09 03:00:00,0,1,0,4,4
2011-11-09 04:00:00,0,1,0,4,4
2011-11-09 05:00:00,0,1,0,28,28
2011-11-09 06:00:00,0,1,0,98,98
2011-11-09 07:00:00,0,1,0,300,300
2011-11-09 08:00:00,0,1,19,437,456
2011-11-09 09:00:00,0,1,22,197,219
2011-11-09 10:00:00,0,1,16,89,105
2011-11-09 11:00:00,0,1,21,131,152
2011-11-09 12:00:00,0,1,24,156,180
2011-11-09 13:00:00,0,1,31,136,167
2011-11-09 14:00:00,0,1,26,153,179
2011-11-09 15:00:00,0,1,21,130,151
2011-11-09 16:00:00,0,1,24,257,281
2011-11-09 17:00:00,0,1,27,458,485
2011-11-09 18:00:00,0,1,21,387,408
2011-11-09 19:00:00,0,1,12,292,304
2011-11-09 20:00:00,0,1,18,201,219
2011-11-09 21:00:00,0,1,9,152,161
2011-11-09 22:00:00,0,1,9,105,114
2011-11-09 23:00:00,0,1,5,61,66
2011-11-10 00:00:00,0,1,0,24,24
2011-11-10 01:00:00,0,1,1,10,11
2011-11-10 02:00:00,0,1,0,5,5
2011-11-10 03:00:00,0,1,0,11,11
2011-11-10 04:00:00,0,1,1,2,3
2011-11-10 05:00:00,0,1,1,22,23
2011-11-10 06:00:00,0,1,4,110,114
2011-11-10 07:00:00,0,1,6,266,272
2011-11-10 08:00:00,0,1,18,418,436
2011-11-10 09:00:00,0,1,23,188,211
2011-11-10 10:00:00,0,1,17,100,117
2011-11-10 11:00:00,0,1,9,99,108
2011-11-10 12:00:00,0,1,18,149,167
2011-11-10 13:00:00,0,1,9,87,96
2011-11-10 14:00:00,0,1,6,58,64
2011-11-10 15:00:00,0,1,5,57,62
2011-11-10 16:00:00,0,1,6,67,73
2011-11-10 17:00:00,0,1,9,168,177
2011-11-10 18:00:00,0,1,10,263,273
2011-11-10 19:00:00,0,1,19,192,211
2011-11-10 20:00:00,0,1,8,160,168
2011-11-10 21:00:00,0,1,6,130,136
2011-11-10 22:00:00,0,1,5,84,89
2011-11-10 23:00:00,0,1,9,73,82
2011-11-11 00:00:00,1,0,10,56,66
2011-11-11 01:00:00,1,0,3,16,19
2011-11-11 02:00:00,1,0,1,10,11
2011-11-11 03:00:00,1,0,0,6,6
2011-11-11 04:00:00,1,0,0,8,8
2011-11-11 05:00:00,1,0,0,13,13
2011-11-11 06:00:00,1,0,0,46,46
2011-11-11 07:00:00,1,0,5,116,121
2011-11-11 08:00:00,1,0,9,249,258
2011-11-11 09:00:00,1,0,15,186,201
2011-11-11 10:00:00,1,0,38,162,200
2011-11-11 11:00:00,1,0,20,150,170
2011-11-11 12:00:00,1,0,41,198,239
2011-11-11 13:00:00,1,0,57,179,236
2011-11-11 14:00:00,1,0,64,183,247
2011-11-11 15:00:00,1,0,29,187,216
2011-11-11 16:00:00,1,0,49,189,238
2011-11-11 17:00:00,1,0,24,286,310
2011-11-11 18:00:00,1,0,23,185,208
2011-11-11 19:00:00,1,0,17,182,199
2011-11-11 20:00:00,1,0,12,97,109
2011-11-11 21:00:00,1,0,4,79,83
2011-11-11 22:00:00,1,0,13,78,91
2011-11-11 23:00:00,1,0,6,67,73
2011-11-12 00:00:00,0,0,12,52,64
2011-11-12 01:00:00,0,0,9,45,54
2011-11-12 02:00:00,0,0,7,39,46
2011-11-12 03:00:00,0,0,4,13,17
2011-11-12 04:00:00,0,0,0,7,7
2011-11-12 05:00:00,0,0,1,3,4
2011-11-12 06:00:00,0,0,0,7,7
2011-11-12 07:00:00,0,0,3,24,27
2011-11-12 08:00:00,0,0,14,87,101
2011-11-12 09:00:00,0,0,18,142,160
2011-11-12 10:00:00,0,0,62,170,232
2011-11-12 11:00:00,0,0,102,213,315
2011-11-12 12:00:00,0,0,142,224,366
2011-11-12 13:00:00,0,0,128,225,353
2011-11-12 14:00:00,0,0,191,244,435
2011-11-12 15:00:00,0,0,165,221,386
2011-11-12 16:00:00,0,0,137,224,361
2011-11-12 17:00:00,0,0,92,193,285
2011-11-12 18:00:00,0,0,53,150,203
2011-11-12 19:00:00,0,0,32,139,171
2011-11-12 20:00:00,0,0,31,101,132
2011-11-12 21:00:00,0,0,19,103,122
2011-11-12 22:00:00,0,0,30,88,118
2011-11-12 23:00:00,0,0,23,78,101
2011-11-13 00:00:00,0,0,12,61,73
2011-11-13 01:00:00,0,0,13,58,71
2011-11-13 02:00:00,0,0,9,48,57
2011-11-13 03:00:00,0,0,8,20,28
2011-11-13 04:00:00,0,0,1,5,6
2011-11-13 05:00:00,0,0,2,3,5
2011-11-13 06:00:00,0,0,5,18,23
2011-11-13 07:00:00,0,0,13,30,43
2011-11-13 08:00:00,0,0,24,55,79
2011-11-13 09:00:00,0,0,38,97,135
2011-11-13 10:00:00,0,0,63,178,241
2011-11-13 11:00:00,0,0,108,187,295
2011-11-13 12:00:00,0,0,112,242,354
2011-11-13 13:00:00,0,0,105,234,339
2011-11-13 14:00:00,0,0,108,263,371
2011-11-13 15:00:00,0,0,89,221,310
2011-11-13 16:00:00,0,0,93,226,319
2011-11-13 17:00:00,0,0,44,187,231
2011-11-13 18:00:00,0,0,35,155,190
2011-11-13 19:00:00,0,0,36,121,157
2011-11-13 20:00:00,0,0,24,115,139
2011-11-13 21:00:00,0,0,19,76,95
2011-11-13 22:00:00,0,0,25,64,89
2011-11-13 23:00:00,0,0,18,49,67
2011-11-14 00:00:00,0,1,8,22,30
2011-11-14 01:00:00,0,1,5,6,11
2011-11-14 02:00:00,0,1,7,10,17
2011-11-14 03:00:00,0,1,4,3,7
2011-11-14 04:00:00,0,1,0,5,5
2011-11-14 05:00:00,0,1,0,19,19
2011-11-14 06:00:00,0,1,10,104,114
2011-11-14 07:00:00,0,1,11,311,322
2011-11-14 08:00:00,0,1,27,425,452
2011-11-14 09:00:00,0,1,29,204,233
2011-11-14 10:00:00,0,1,26,85,111
2011-11-14 11:00:00,0,1,22,106,128
2011-11-14 12:00:00,0,1,36,166,202
2011-11-14 13:00:00,0,1,50,153,203
2011-11-14 14:00:00,0,1,47,138,185
2011-11-14 15:00:00,0,1,53,142,195
2011-11-14 16:00:00,0,1,51,264,315
2011-11-14 17:00:00,0,1,55,464,519
2011-11-14 18:00:00,0,1,29,460,489
2011-11-14 19:00:00,0,1,28,274,302
2011-11-14 20:00:00,0,1,30,210,240
2011-11-14 21:00:00,0,1,37,176,213
2011-11-14 22:00:00,0,1,17,96,113
2011-11-14 23:00:00,0,1,13,48,61
2011-11-15 00:00:00,0,1,7,15,22
2011-11-15 01:00:00,0,1,5,5,10
2011-11-15 02:00:00,0,1,7,8,15
2011-11-15 03:00:00,0,1,0,4,4
2011-11-15 04:00:00,0,1,1,6,7
2011-11-15 05:00:00,0,1,2,26,28
2011-11-15 06:00:00,0,1,4,104,108
2011-11-15 07:00:00,0,1,21,298,319
2011-11-15 08:00:00,0,1,27,453,480
2011-11-15 09:00:00,0,1,26,174,200
2011-11-15 10:00:00,0,1,23,115,138
2011-11-15 11:00:00,0,1,18,116,134
2011-11-15 12:00:00,0,1,28,148,176
2011-11-15 13:00:00,0,1,21,132,153
2011-11-15 14:00:00,0,1,27,120,147
2011-11-15 15:00:00,0,1,36,155,191
2011-11-15 16:00:00,0,1,31,240,271
2011-11-15 17:00:00,0,1,29,422,451
2011-11-15 18:00:00,0,1,27,414,441
2011-11-15 19:00:00,0,1,27,259,286
2011-11-15 20:00:00,0,1,26,212,238
2011-11-15 21:00:00,0,1,23,145,168
2011-11-15 22:00:00,0,1,19,109,128
2011-11-15 23:00:00,0,1,14,66,80
2011-11-16 00:00:00,0,1,5,26,31
2011-11-16 01:00:00,0,1,0,5,5
2011-11-16 02:00:00,0,1,4,6,10
2011-11-16 03:00:00,0,1,2,3,5
2011-11-16 04:00:00,0,1,1,3,4
2011-11-16 05:00:00,0,1,0,13,13
2011-11-16 06:00:00,0,1,4,52,56
2011-11-16 07:00:00,0,1,7,130,137
2011-11-16 08:00:00,0,1,9,223,232
2011-11-16 09:00:00,0,1,5,77,82
2011-11-16 10:00:00,0,1,4,32,36
2011-11-16 11:00:00,0,1,7,53,60
2011-11-16 12:00:00,0,1,5,49,54
2011-11-16 13:00:00,0,1,6,52,58
2011-11-16 14:00:00,0,1,12,49,61
2011-11-16 15:00:00,0,1,16,50,66
2011-11-16 16:00:00,0,1,13,110,123
2011-11-16 17:00:00,0,1,17,216,233
2011-11-16 18:00:00,0,1,13,176,189
2011-11-16 19:00:00,0,1,3,108,111
2011-11-16 20:00:00,0,1,5,94,99
2011-11-16 21:00:00,0,1,3,72,75
2011-11-16 22:00:00,0,1,1,45,46
2011-11-16 23:00:00,0,1,3,28,31
2011-11-17 00:00:00,0,1,2,22,24
2011-11-17 01:00:00,0,1,0,5,5
2011-11-17 02:00:00,0,1,0,5,5
2011-11-17 03:00:00,0,1,0,3,3
2011-11-17 04:00:00,0,1,1,3,4
2011-11-17 05:00:00,0,1,1,21,22
2011-11-17 06:00:00,0,1,3,72,75
2011-11-17 07:00:00,0,1,4,164,168
2011-11-17 08:00:00,0,1,12,343,355
2011-11-17 09:00:00,0,1,14,184,198
2011-11-17 10:00:00,0,1,7,74,81
2011-11-17 11:00:00,0,1,4,93,97
2011-11-17 12:00:00,0,1,6,115,121
2011-11-17 13:00:00,0,1,15,109,124
2011-11-17 14:00:00,0,1,5,105,110
2011-11-17 15:00:00,0,1,10,106,116
2011-11-17 16:00:00,0,1,8,187,195
2011-11-17 17:00:00,0,1,20,379,399
2011-11-17 18:00:00,0,1,9,298,307
2011-11-17 19:00:00,0,1,7,210,217
2011-11-17 20:00:00,0,1,7,162,169
2011-11-17 21:00:00,0,1,3,113,116
2011-11-17 22:00:00,0,1,1,83,84
2011-11-17 23:00:00,0,1,0,58,58
2011-11-18 00:00:00,0,1,2,28,30
2011-11-18 01:00:00,0,1,0,10,10
2011-11-18 02:00:00,0,1,2,8,10
2011-11-18 03:00:00,0,1,0,2,2
2011-11-18 04:00:00,0,1,0,5,5
2011-11-18 05:00:00,0,1,0,22,22
2011-11-18 06:00:00,0,1,1,70,71
2011-11-18 07:00:00,0,1,5,211,216
2011-11-18 08:00:00,0,1,6,369,375
2011-11-18 09:00:00,0,1,6,207,213
2011-11-18 10:00:00,0,1,10,105,115
2011-11-18 11:00:00,0,1,18,122,140
2011-11-18 12:00:00,0,1,22,143,165
2011-11-18 13:00:00,0,1,31,146,177
2011-11-18 14:00:00,0,1,31,123,154
2011-11-18 15:00:00,0,1,27,151,178
2011-11-18 16:00:00,0,1,19,190,209
2011-11-18 17:00:00,0,1,17,361,378
2011-11-18 18:00:00,0,1,16,312,328
2011-11-18 19:00:00,0,1,7,183,190
2011-11-18 20:00:00,0,1,8,129,137
2011-11-18 21:00:00,0,1,3,108,111
2011-11-18 22:00:00,0,1,9,88,97
2011-11-18 23:00:00,0,1,5,54,59
2011-11-19 00:00:00,0,0,4,49,53
2011-11-19 01:00:00,0,0,1,34,35
2011-11-19 02:00:00,0,0,12,34,46
2011-11-19 03:00:00,0,0,4,11,15
2011-11-19 04:00:00,0,0,4,4,8
2011-11-19 05:00:00,0,0,0,2,2
2011-11-19 06:00:00,0,0,2,10,12
2011-11-19 07:00:00,0,0,3,38,41
2011-11-19 08:00:00,0,0,12,80,92
2011-11-19 09:00:00,0,0,12,130,142
2011-11-19 10:00:00,0,0,35,165,200
2011-11-19 11:00:00,0,0,50,183,233
2011-11-19 12:00:00,0,0,93,218,311
2011-11-19 13:00:00,0,0,118,245,363
2011-11-19 14:00:00,0,0,121,228,349
2011-11-19 15:00:00,0,0,120,262,382
2011-11-19 16:00:00,0,0,99,188,287
2011-11-19 17:00:00,0,0,61,171,232
2011-11-19 18:00:00,0,0,36,172,208
2011-11-19 19:00:00,0,0,33,149,182
2011-11-19 20:00:00,0,0,48,115,163
2011-11-19 21:00:00,0,0,29,79,108
2011-11-19 22:00:00,0,0,26,80,106
2011-11-19 23:00:00,0,0,20,73,93
2011-12-01 00:00:00,0,1,1,19,20
2011-12-01 01:00:00,0,1,1,9,10
2011-12-01 02:00:00,0,1,1,8,9
2011-12-01 03:00:00,0,1,1,6,7
2011-12-01 04:00:00,0,1,0,1,1
2011-12-01 05:00:00,0,1,1,23,24
2011-12-01 06:00:00,0,1,5,92,97
2011-12-01 07:00:00,0,1,11,265,276
2011-12-01 08:00:00,0,1,15,462,477
2011-12-01 09:00:00,0,1,9,215,224
2011-12-01 10:00:00,0,1,7,86,93
2011-12-01 11:00:00,0,1,7,95,102
2011-12-01 12:00:00,0,1,9,139,148
2011-12-01 13:00:00,0,1,17,137,154
2011-12-01 14:00:00,0,1,20,130,150
2011-12-01 15:00:00,0,1,10,144,154
2011-12-01 16:00:00,0,1,9,192,201
2011-12-01 17:00:00,0,1,9,409,418
2011-12-01 18:00:00,0,1,12,393,405
2011-12-01 19:00:00,0,1,9,219,228
2011-12-01 20:00:00,0,1,12,178,190
2011-12-01 21:00:00,0,1,8,154,162
2011-12-01 22:00:00,0,1,5,99,104
2011-12-01 23:00:00,0,1,3,70,73
2011-12-02 00:00:00,0,1,6,32,38
2011-12-02 01:00:00,0,1,1,14,15
2011-12-02 02:00:00,0,1,0,10,10
2011-12-02 03:00:00,0,1,0,1,1
2011-12-02 04:00:00,0,1,0,3,3
2011-12-02 05:00:00,0,1,0,23,23
2011-12-02 06:00:00,0,1,3,84,87
2011-12-02 07:00:00,0,1,6,199,205
2011-12-02 08:00:00,0,1,13,432,445
2011-12-02 09:00:00,0,1,12,234,246
2011-12-02 10:00:00,0,1,16,89,105
2011-12-02 11:00:00,0,1,18,142,160
2011-12-02 12:00:00,0,1,18,186,204
2011-12-02 13:00:00,0,1,19,188,207
2011-12-02 14:00:00,0,1,25,145,170
2011-12-02 15:00:00,0,1,24,175,199
2011-12-02 16:00:00,0,1,22,254,276
2011-12-02 17:00:00,0,1,20,391,411
2011-12-02 18:00:00,0,1,10,362,372
2011-12-02 19:00:00,0,1,13,252,265
2011-12-02 20:00:00,0,1,12,178,190
2011-12-02 21:00:00,0,1,9,102,111
2011-12-02 22:00:00,0,1,7,95,102
2011-12-02 23:00:00,0,1,14,81,95
2011-12-03 00:00:00,0,0,10,65,75
2011-12-03 01:00:00,0,0,9,62,71
2011-12-03 02:00:00,0,0,9,41,50
2011-12-03 03:00:00,0,0,4,5,9
2011-12-03 04:00:00,0,0,1,7,8
2011-12-03 05:00:00,0,0,0,6,6
2011-12-03 06:00:00,0,0,1,10,11
2011-12-03 07:00:00,0,0,2,24,26
2011-12-03 08:00:00,0,0,1,62,63
2011-12-03 09:00:00,0,0,25,99,124
2011-12-03 10:00:00,0,0,22,173,195
2011-12-03 11:00:00,0,0,48,227,275
2011-12-03 12:00:00,0,0,78,280,358
2011-12-03 13:00:00,0,0,70,222,292
2011-12-03 14:00:00,0,0,92,251,343
2011-12-03 15:00:00,0,0,100,237,337
2011-12-03 16:00:00,0,0,75,230,305
2011-12-03 17:00:00,0,0,46,186,232
2011-12-03 18:00:00,0,0,31,193,224
2011-12-03 19:00:00,0,0,31,144,175
2011-12-03 20:00:00,0,0,17,110,127
2011-12-03 21:00:00,0,0,5,104,109
2011-12-03 22:00:00,0,0,17,97,114
2011-12-03 23:00:00,0,0,12,73,85
2011-12-04 00:00:00,0,0,19,64,83
2011-12-04 01:00:00,0,0,20,54,74
2011-12-04 02:00:00,0,0,11,51,62
2011-12-04 03:00:00,0,0,7,34,41
2011-12-04 04:00:00,0,0,2,9,11
2011-12-04 05:00:00,0,0,2,2,4
2011-12-04 06:00:00,0,0,1,3,4
2011-12-04 07:00:00,0,0,3,23,26
2011-12-04 08:00:00,0,0,7,48,55
2011-12-04 09:00:00,0,0,12,114,126
2011-12-04 10:00:00,0,0,36,180,216
2011-12-04 11:00:00,0,0,48,206,254
2011-12-04 12:00:00,0,0,82,247,329
2011-12-04 13:00:00,0,0,88,269,357
2011-12-04 14:00:00,0,0,77,246,323
2011-12-04 15:00:00,0,0,69,227,296
2011-12-04 16:00:00,0,0,64,266,330
2011-12-04 17:00:00,0,0,38,207,245
2011-12-04 18:00:00,0,0,10,161,171
2011-12-04 19:00:00,0,0,15,158,173
2011-12-04 20:00:00,0,0,8,116,124
2011-12-04 21:00:00,0,0,7,65,72
2011-12-04 22:00:00,0,0,5,59,64
2011-12-04 23:00:00,0,0,3,42,45
2011-12-05 00:00:00,0,1,3,21,24
2011-12-05 01:00:00,0,1,2,10,12
2011-12-05 02:00:00,0,1,0,8,8
2011-12-05 03:00:00,0,1,0,2,2
2011-12-05 04:00:00,0,1,0,7,7
2011-12-05 05:00:00,0,1,1,24,25
2011-12-05 06:00:00,0,1,1,89,90
2011-12-05 07:00:00,0,1,9,274,283
2011-12-05 08:00:00,0,1,12,392,404
2011-12-05 09:00:00,0,1,12,178,190
2011-12-05 10:00:00,0,1,9,78,87
2011-12-05 11:00:00,0,1,17,106,123
2011-12-05 12:00:00,0,1,29,125,154
2011-12-05 13:00:00,0,1,18,153,171
2011-12-05 14:00:00,0,1,7,126,133
2011-12-05 15:00:00,0,1,16,132,148
2011-12-05 16:00:00,0,1,10,238,248
2011-12-05 17:00:00,0,1,16,430,446
2011-12-05 18:00:00,0,1,13,386,399
2011-12-05 19:00:00,0,1,13,295,308
2011-12-05 20:00:00,0,1,15,190,205
2011-12-05 21:00:00,0,1,10,166,176
2011-12-05 22:00:00,0,1,12,94,106
2011-12-05 23:00:00,0,1,8,54,62
2011-12-06 00:00:00,0,1,3,25,28
2011-12-06 01:00:00,0,1,2,14,16
2011-12-06 02:00:00,0,1,0,3,3
2011-12-06 03:00:00,0,1,0,3,3
2011-12-06 04:00:00,0,1,0,7,7
2011-12-06 05:00:00,0,1,0,20,20
2011-12-06 06:00:00,0,1,5,81,86
2011-12-06 07:00:00,0,1,7,227,234
2011-12-06 08:00:00,0,1,13,401,414
2011-12-06 09:00:00,0,1,4,200,204
2011-12-06 10:00:00,0,1,6,44,50
2011-12-06 11:00:00,0,1,4,28,32
2011-12-06 12:00:00,0,1,5,50,55
2011-12-06 13:00:00,0,1,6,65,71
2011-12-06 14:00:00,0,1,6,69,75
2011-12-06 15:00:00,0,1,2,43,45
2011-12-06 16:00:00,0,1,4,84,88
2011-12-06 17:00:00,0,1,13,249,262
2011-12-06 18:00:00,0,1,17,287,304
2011-12-06 19:00:00,0,1,10,223,233
2011-12-06 20:00:00,0,1,3,107,110
2011-12-06 21:00:00,0,1,6,108,114
2011-12-06 22:00:00,0,1,5,82,87
2011-12-06 23:00:00,0,1,5,48,53
2011-12-07 00:00:00,0,1,3,30,33
2011-12-07 01:00:00,0,1,4,9,13
2011-12-07 02:00:00,0,1,2,4,6
2011-12-07 03:00:00,0,1,0,3,3
2011-12-07 04:00:00,0,1,0,1,1
2011-12-07 05:00:00,0,1,0,3,3
2011-12-07 06:00:00,0,1,0,18,18
2011-12-07 07:00:00,0,1,3,43,46
2011-12-07 08:00:00,0,1,6,80,86
2011-12-07 09:00:00,0,1,0,64,64
2011-12-07 10:00:00,0,1,1,32,33
2011-12-07 11:00:00,0,1,3,47,50
2011-12-07 12:00:00,0,1,4,29,33
2011-12-07 13:00:00,0,1,5,28,33
2011-12-07 14:00:00,0,1,1,24,25
2011-12-07 15:00:00,0,1,5,25,30
2011-12-07 16:00:00,0,1,3,28,31
2011-12-07 17:00:00,0,1,4,48,52
2011-12-07 18:00:00,0,1,3,48,51
2011-12-07 19:00:00,0,1,2,31,33
2011-12-07 20:00:00,0,1,1,25,26
2011-12-07 21:00:00,0,1,0,6,6
2011-12-07 22:00:00,0,1,0,13,13
2011-12-07 23:00:00,0,1,0,16,16
2011-12-08 00:00:00,0,1,0,21,21
2011-12-08 01:00:00,0,1,1,6,7
2011-12-08 02:00:00,0,1,0,4,4
2011-12-08 03:00:00,0,1,0,1,1
2011-12-08 04:00:00,0,1,0,2,2
2011-12-08 05:00:00,0,1,0,12,12
2011-12-08 06:00:00,0,1,0,71,71
2011-12-08 07:00:00,0,1,11,233,244
2011-12-08 08:00:00,0,1,11,418,429
2011-12-08 09:00:00,0,1,7,218,225
2011-12-08 10:00:00,0,1,1,109,110
2011-12-08 11:00:00,0,1,6,100,106
2011-12-08 12:00:00,0,1,8,148,156
2011-12-08 13:00:00,0,1,9,115,124
2011-12-08 14:00:00,0,1,16,121,137
2011-12-08 15:00:00,0,1,19,98,117
2011-12-08 16:00:00,0,1,7,201,208
2011-12-08 17:00:00,0,1,10,321,331
2011-12-08 18:00:00,0,1,12,306,318
2011-12-08 19:00:00,0,1,12,220,232
2011-12-08 20:00:00,0,1,5,170,175
2011-12-08 21:00:00,0,1,4,135,139
2011-12-08 22:00:00,0,1,8,84,92
2011-12-08 23:00:00,0,1,3,58,61
2011-12-09 00:00:00,0,1,8,26,34
2011-12-09 01:00:00,0,1,2,12,14
2011-12-09 02:00:00,0,1,2,10,12
2011-12-09 03:00:00,0,1,1,5,6
2011-12-09 04:00:00,0,1,1,1,2
2011-12-09 05:00:00,0,1,0,20,20
2011-12-09 06:00:00,0,1,1,62,63
2011-12-09 07:00:00,0,1,4,195,199
2011-12-09 08:00:00,0,1,7,378,385
2011-12-09 09:00:00,0,1,8,256,264
2011-12-09 10:00:00,0,1,11,115,126
2011-12-09 11:00:00,0,1,15,121,136
2011-12-09 12:00:00,0,1,27,146,173
2011-12-09 13:00:00,0,1,27,141,168
2011-12-09 14:00:00,0,1,24,163,187
2011-12-09 15:00:00,0,1,29,160,189
2011-12-09 16:00:00,0,1,24,226,250
2011-12-09 17:00:00,0,1,10,352,362
2011-12-09 18:00:00,0,1,10,308,318
2011-12-09 19:00:00,0,1,10,189,199
2011-12-09 20:00:00,0,1,10,140,150
2011-12-09 21:00:00,0,1,9,131,140
2011-12-09 22:00:00,0,1,15,114,129
2011-12-09 23:00:00,0,1,6,88,94
2011-12-10 00:00:00,0,0,11,66,77
2011-12-10 01:00:00,0,0,11,55,66
2011-12-10 02:00:00,0,0,12,48,60
2011-12-10 03:00:00,0,0,5,20,25
2011-12-10 04:00:00,0,0,0,3,3
2011-12-10 05:00:00,0,0,0,6,6
2011-12-10 06:00:00,0,0,1,10,11
2011-12-10 07:00:00,0,0,0,11,11
2011-12-10 08:00:00,0,0,5,68,73
2011-12-10 09:00:00,0,0,15,134,149
2011-12-10 10:00:00,0,0,31,161,192
2011-12-10 11:00:00,0,0,44,192,236
2011-12-10 12:00:00,0,0,48,235,283
2011-12-10 13:00:00,0,0,47,239,286
2011-12-10 14:00:00,0,0,51,242,293
2011-12-10 15:00:00,0,0,60,239,299
2011-12-10 16:00:00,0,0,58,183,241
2011-12-10 17:00:00,0,0,34,151,185
2011-12-10 18:00:00,0,0,28,144,172
2011-12-10 19:00:00,0,0,15,139,154
2011-12-10 20:00:00,0,0,10,114,124
2011-12-10 21:00:00,0,0,4,79,83
2011-12-10 22:00:00,0,0,7,88,95
2011-12-10 23:00:00,0,0,5,61,66
2011-12-11 00:00:00,0,0,5,69,74
2011-12-11 01:00:00,0,0,8,54,62
2011-12-11 02:00:00,0,0,5,47,52
2011-12-11 03:00:00,0,0,2,17,19
2011-12-11 04:00:00,0,0,0,5,5
2011-12-11 05:00:00,0,0,0,6,6
2011-12-11 06:00:00,0,0,0,10,10
2011-12-11 07:00:00,0,0,1,30,31
2011-12-11 08:00:00,0,0,4,68,72
2011-12-11 09:00:00,0,0,19,88,107
2011-12-11 10:00:00,0,0,30,164,194
2011-12-11 11:00:00,0,0,31,166,197
2011-12-11 12:00:00,0,0,42,246,288
2011-12-11 13:00:00,0,0,44,224,268
2011-12-11 14:00:00,0,0,44,198,242
2011-12-11 15:00:00,0,0,47,219,266
2011-12-11 16:00:00,0,0,32,174,206
2011-12-11 17:00:00,0,0,13,150,163
2011-12-11 18:00:00,0,0,12,151,163
2011-12-11 19:00:00,0,0,7,98,105
2011-12-11 20:00:00,0,0,10,62,72
2011-12-11 21:00:00,0,0,10,53,63
2011-12-11 22:00:00,0,0,7,36,43
2011-12-11 23:00:00,0,0,4,31,35
2011-12-12 00:00:00,0,1,4,16,20
2011-12-12 01:00:00,0,1,0,9,9
2011-12-12 02:00:00,0,1,0,4,4
2011-12-12 03:00:00,0,1,0,2,2
2011-12-12 04:00:00,0,1,0,3,3
2011-12-12 05:00:00,0,1,0,21,21
2011-12-12 06:00:00,0,1,1,63,64
2011-12-12 07:00:00,0,1,4,231,235
2011-12-12 08:00:00,0,1,7,378,385
2011-12-12 09:00:00,0,1,12,208,220
2011-12-12 10:00:00,0,1,14,91,105
2011-12-12 11:00:00,0,1,15,100,115
2011-12-12 12:00:00,0,1,7,138,145
2011-12-12 13:00:00,0,1,13,153,166
2011-12-12 14:00:00,0,1,16,95,111
2011-12-12 15:00:00,0,1,8,124,132
2011-12-12 16:00:00,0,1,5,209,214
2011-12-12 17:00:00,0,1,7,352,359
2011-12-12 18:00:00,0,1,8,349,357
2011-12-12 19:00:00,0,1,9,232,241
2011-12-12 20:00:00,0,1,8,157,165
2011-12-12 21:00:00,0,1,2,119,121
2011-12-12 22:00:00,0,1,0,71,71
2011-12-12 23:00:00,0,1,3,42,45
2011-12-13 00:00:00,0,1,1,16,17
2011-12-13 01:00:00,0,1,0,4,4
2011-12-13 02:00:00,0,1,1,1,2
2011-12-13 03:00:00,0,1,0,3,3
2011-12-13 04:00:00,0,1,0,4,4
2011-12-13 05:00:00,0,1,0,20,20
2011-12-13 06:00:00,0,1,0,92,92
2011-12-13 07:00:00,0,1,2,221,223
2011-12-13 08:00:00,0,1,9,391,400
2011-12-13 09:00:00,0,1,10,223,233
2011-12-13 10:00:00,0,1,3,99,102
2011-12-13 11:00:00,0,1,9,115,124
2011-12-13 12:00:00,0,1,20,147,167
2011-12-13 13:00:00,0,1,7,120,127
2011-12-13 14:00:00,0,1,18,116,134
2011-12-13 15:00:00,0,1,7,144,151
2011-12-13 16:00:00,0,1,13,194,207
2011-12-13 17:00:00,0,1,17,381,398
2011-12-13 18:00:00,0,1,12,370,382
2011-12-13 19:00:00,0,1,5,262,267
2011-12-13 20:00:00,0,1,7,154,161
2011-12-13 21:00:00,0,1,5,134,139
2011-12-13 22:00:00,0,1,5,102,107
2011-12-13 23:00:00,0,1,4,55,59
2011-12-14 00:00:00,0,1,0,22,22
2011-12-14 01:00:00,0,1,0,8,8
2011-12-14 02:00:00,0,1,0,2,2
2011-12-14 03:00:00,0,1,0,3,3
2011-12-14 04:00:00,0,1,0,4,4
2011-12-14 05:00:00,0,1,0,26,26
2011-12-14 06:00:00,0,1,0,87,87
2011-12-14 07:00:00,0,1,4,243,247
2011-12-14 08:00:00,0,1,9,458,467
2011-12-14 09:00:00,0,1,9,230,239
2011-12-14 10:00:00,0,1,9,133,142
2011-12-14 11:00:00,0,1,12,103,115
2011-12-14 12:00:00,0,1,6,138,144
2011-12-14 13:00:00,0,1,14,119,133
2011-12-14 14:00:00,0,1,17,134,151
2011-12-14 15:00:00,0,1,24,143,167
2011-12-14 16:00:00,0,1,12,233,245
2011-12-14 17:00:00,0,1,19,377,396
2011-12-14 18:00:00,0,1,11,379,390
2011-12-14 19:00:00,0,1,9,259,268
2011-12-14 20:00:00,0,1,6,169,175
2011-12-14 21:00:00,0,1,9,145,154
2011-12-14 22:00:00,0,1,5,99,104
2011-12-14 23:00:00,0,1,3,48,51
2011-12-15 00:00:00,0,1,5,45,50
2011-12-15 01:00:00,0,1,5,15,20
2011-12-15 02:00:00,0,1,2,5,7
2011-12-15 03:00:00,0,1,1,2,3
2011-12-15 04:00:00,0,1,0,6,6
2011-12-15 05:00:00,0,1,0,24,24
2011-12-15 06:00:00,0,1,2,90,92
2011-12-15 07:00:00,0,1,6,252,258
2011-12-15 08:00:00,0,1,8,449,457
2011-12-15 09:00:00,0,1,6,274,280
2011-12-15 10:00:00,0,1,4,105,109
2011-12-15 11:00:00,0,1,9,126,135
2011-12-15 12:00:00,0,1,17,140,157
2011-12-15 13:00:00,0,1,14,150,164
2011-12-15 14:00:00,0,1,8,124,132
2011-12-15 15:00:00,0,1,6,76,82
2011-12-15 16:00:00,0,1,7,124,131
2011-12-15 17:00:00,0,1,14,310,324
2011-12-15 18:00:00,0,1,14,363,377
2011-12-15 19:00:00,0,1,13,274,287
2011-12-15 20:00:00,0,1,12,209,221
2011-12-15 21:00:00,0,1,10,145,155
2011-12-15 22:00:00,0,1,8,116,124
2011-12-15 23:00:00,0,1,10,104,114
2011-12-16 00:00:00,0,1,12,60,72
2011-12-16 01:00:00,0,1,3,28,31
2011-12-16 02:00:00,0,1,0,23,23
2011-12-16 03:00:00,0,1,2,3,5
2011-12-16 04:00:00,0,1,1,4,5
2011-12-16 05:00:00,0,1,0,26,26
2011-12-16 06:00:00,0,1,2,80,82
2011-12-16 07:00:00,0,1,5,226,231
2011-12-16 08:00:00,0,1,10,449,459
2011-12-16 09:00:00,0,1,8,235,243
2011-12-16 10:00:00,0,1,10,122,132
2011-12-16 11:00:00,0,1,9,135,144
2011-12-16 12:00:00,0,1,10,163,173
2011-12-16 13:00:00,0,1,12,125,137
2011-12-16 14:00:00,0,1,13,115,128
2011-12-16 15:00:00,0,1,12,141,153
2011-12-16 16:00:00,0,1,12,212,224
2011-12-16 17:00:00,0,1,13,352,365
2011-12-16 18:00:00,0,1,10,285,295
2011-12-16 19:00:00,0,1,11,203,214
2011-12-16 20:00:00,0,1,6,146,152
2011-12-16 21:00:00,0,1,7,95,102
2011-12-16 22:00:00,0,1,6,100,106
2011-12-16 23:00:00,0,1,4,71,75
2011-12-17 00:00:00,0,0,3,59,62
2011-12-17 01:00:00,0,0,4,39,43
2011-12-17 02:00:00,0,0,11,47,58
2011-12-17 03:00:00,0,0,4,22,26
2011-12-17 04:00:00,0,0,0,9,9
2011-12-17 05:00:00,0,0,2,7,9
2011-12-17 06:00:00,0,0,0,17,17
2011-12-17 07:00:00,0,0,0,20,20
2011-12-17 08:00:00,0,0,4,55,59
2011-12-17 09:00:00,0,0,5,95,100
2011-12-17 10:00:00,0,0,10,171,181
2011-12-17 11:00:00,0,0,21,188,209
2011-12-17 12:00:00,0,0,28,216,244
2011-12-17 13:00:00,0,0,32,204,236
2011-12-17 14:00:00,0,0,30,207,237
2011-12-17 15:00:00,0,0,33,195,228
2011-12-17 16:00:00,0,0,30,192,222
2011-12-17 17:00:00,0,0,12,153,165
2011-12-17 18:00:00,0,0,7,150,157
2011-12-17 19:00:00,0,0,11,95,106
2011-12-17 20:00:00,0,0,7,99,106
2011-12-17 21:00:00,0,0,8,88,96
2011-12-17 22:00:00,0,0,7,73,80
2011-12-17 23:00:00,0,0,6,63,69
2011-12-18 00:00:00,0,0,7,64,71
2011-12-18 01:00:00,0,0,3,43,46
2011-12-18 02:00:00,0,0,2,39,41
2011-12-18 03:00:00,0,0,2,16,18
2011-12-18 04:00:00,0,0,0,1,1
2011-12-18 05:00:00,0,0,1,4,5
2011-12-18 06:00:00,0,0,0,3,3
2011-12-18 07:00:00,0,0,1,11,12
2011-12-18 08:00:00,0,0,1,31,32
2011-12-18 09:00:00,0,0,6,75,81
2011-12-18 10:00:00,0,0,7,122,129
2011-12-18 11:00:00,0,0,20,168,188
2011-12-18 12:00:00,0,0,26,202,228
2011-12-18 13:00:00,0,0,18,210,228
2011-12-18 14:00:00,0,0,19,200,219
2011-12-18 15:00:00,0,0,23,184,207
2011-12-18 16:00:00,0,0,27,207,234
2011-12-18 17:00:00,0,0,10,126,136
2011-12-18 18:00:00,0,0,15,123,138
2011-12-18 19:00:00,0,0,5,130,135
2011-12-18 20:00:00,0,0,10,94,104
2011-12-18 21:00:00,0,0,9,80,89
2011-12-18 22:00:00,0,0,2,47,49
2011-12-18 23:00:00,0,0,6,31,37
2011-12-19 00:00:00,0,1,3,14,17
2011-12-19 01:00:00,0,1,3,8,11
2011-12-19 02:00:00,0,1,0,3,3
2011-12-19 03:00:00,0,1,0,3,3
2011-12-19 04:00:00,0,1,0,4,4
2011-12-19 05:00:00,0,1,0,21,21
2011-12-19 06:00:00,0,1,0,68,68
2011-12-19 07:00:00,0,1,4,187,191
2011-12-19 08:00:00,0,1,8,389,397
2011-12-19 09:00:00,0,1,17,166,183
2011-12-19 10:00:00,0,1,12,96,108
2011-12-19 11:00:00,0,1,22,105,127
2011-12-19 12:00:00,0,1,13,128,141
2011-12-19 13:00:00,0,1,15,127,142
2011-12-19 14:00:00,0,1,30,107,137
2011-12-19 15:00:00,0,1,24,135,159
2011-12-19 16:00:00,0,1,19,189,208
2011-12-19 17:00:00,0,1,16,362,378
2011-12-19 18:00:00,0,1,11,343,354
2011-12-19 19:00:00,0,1,17,234,251
2011-12-19 20:00:00,0,1,9,197,206
2011-12-19 21:00:00,0,1,15,112,127
2011-12-19 22:00:00,0,1,12,95,107
2011-12-19 23:00:00,0,1,10,50,60
