datetime,holiday,workingday,casual,registered,count
2012-01-01 00:00:00,0,0,5,43,48
2012-01-01 01:00:00,0,0,15,78,93
2012-01-01 02:00:00,0,0,16,59,75
2012-01-01 03:00:00,0,0,11,41,52
2012-01-01 04:00:00,0,0,0,8,8
2012-01-01 05:00:00,0,0,0,5,5
2012-01-01 06:00:00,0,0,1,1,2
2012-01-01 07:00:00,0,0,1,6,7
2012-01-01 08:00:00,0,0,4,10,14
2012-01-01 09:00:00,0,0,13,27,40
2012-01-01 10:00:00,0,0,18,52,70
2012-01-01 11:00:00,0,0,40,98,138
2012-01-01 12:00:00,0,0,58,143,201
2012-01-01 13:00:00,0,0,82,141,223
2012-01-01 14:00:00,0,0,120,147,267
2012-01-01 15:00:00,0,0,101,164,265
2012-01-01 16:00:00,0,0,68,147,215
2012-01-01 17:00:00,0,0,36,75,111
2012-01-01 18:00:00,0,0,25,81,106
2012-01-01 19:00:00,0,0,20,85,105
2012-01-01 20:00:00,0,0,25,58,83
2012-01-01 21:00:00,0,0,10,61,71
2012-01-01 22:00:00,0,0,13,53,66
2012-01-01 23:00:00,0,0,4,25,29
2012-01-02 00:00:00,1,0,8,31,39
2012-01-02 01:00:00,1,0,1,11,12
2012-01-02 02:00:00,1,0,1,6,7
2012-01-02 04:00:00,1,0,0,4,4
2012-01-02 05:00:00,1,0,1,3,4
2012-01-02 06:00:00,1,0,0,14,14
2012-01-02 07:00:00,1,0,0,16,16
2012-01-02 08:00:00,1,0,2,51,53
2012-01-02 09:00:00,1,0,15,53,68
2012-01-02 10:00:00,1,0,20,89,109
2012-01-02 11:00:00,1,0,33,142,175
2012-01-02 12:00:00,1,0,41,161,202
2012-01-02 13:00:00,1,0,26,150,176
2012-01-02 14:00:00,1,0,10,141,151
2012-01-02 15:00:00,1,0,29,139,168
2012-01-02 16:00:00,1,0,10,144,154
2012-01-02 17:00:00,1,0,17,136,153
2012-01-02 18:00:00,1,0,13,113,126
2012-01-02 19:00:00,1,0,4,89,93
2012-01-02 20:00:00,1,0,5,83,88
2012-01-02 21:00:00,1,0,3,63,66
2012-01-02 22:00:00,1,0,3,36,39
2012-01-02 23:00:00,1,0,2,32,34
2012-01-03 00:00:00,0,1,0,13,13
2012-01-03 01:00:00,0,1,1,5,6
2012-01-03 02:00:00,0,1,0,3,3
2012-01-03 03:00:00,0,1,0,2,2
2012-01-03 04:00:00,0,1,0,5,5
2012-01-03 05:00:00,0,1,0,12,12
2012-01-03 06:00:00,0,1,4,81,85
2012-01-03 07:00:00,0,1,2,168,170
2012-01-03 08:00:00,0,1,5,349,354
2012-01-03 09:00:00,0,1,8,145,153
2012-01-03 10:00:00,0,1,5,55,60
2012-01-03 11:00:00,0,1,12,63,75
2012-01-03 12:00:00,0,1,4,70,74
2012-01-03 13:00:00,0,1,5,68,73
2012-01-03 14:00:00,0,1,7,72,79
2012-01-03 15:00:00,0,1,9,68,77
2012-01-03 16:00:00,0,1,7,129,136
2012-01-03 17:00:00,0,1,4,241,245
2012-01-03 18:00:00,0,1,10,214,224
2012-01-03 19:00:00,0,1,4,152,156
2012-01-03 20:00:00,0,1,0,115,115
2012-01-03 21:00:00,0,1,2,66,68
2012-01-03 22:00:00,0,1,0,33,33
2012-01-03 23:00:00,0,1,0,18,18
2012-01-04 00:00:00,0,1,0,9,9
2012-01-04 01:00:00,0,1,0,3,3
2012-01-04 02:00:00,0,1,0,1,1
2012-01-04 03:00:00,0,1,0,1,1
2012-01-04 04:00:00,0,1,0,2,2
2012-01-04 05:00:00,0,1,0,14,14
2012-01-04 06:00:00,0,1,0,59,59
2012-01-04 07:00:00,0,1,1,151,152
2012-01-04 08:00:00,0,1,5,310,315
2012-01-04 09:00:00,0,1,7,173,180
2012-01-04 10:00:00,0,1,7,57,64
2012-01-04 11:00:00,0,1,6,40,46
2012-01-04 12:00:00,0,1,9,75,84
2012-01-04 13:00:00,0,1,9,82,91
2012-01-04 14:00:00,0,1,6,69,75
2012-01-04 15:00:00,0,1,9,81,90
2012-01-04 16:00:00,0,1,8,123,131
2012-01-04 17:00:00,0,1,9,272,281
2012-01-04 18:00:00,0,1,9,280,289
2012-01-04 19:00:00,0,1,2,182,184
2012-01-04 20:00:00,0,1,2,121,123
2012-01-04 21:00:00,0,1,2,88,90
2012-01-04 22:00:00,0,1,4,48,52
2012-01-04 23:00:00,0,1,0,32,32
2012-01-05 00:00:00,0,1,1,13,14
2012-01-05 01:00:00,0,1,0,5,5
2012-01-05 02:00:00,0,1,0,4,4
2012-01-05 03:00:00,0,1,0,4,4
2012-01-05 04:00:00,0,1,0,5,5
2012-01-05 05:00:00,0,1,0,26,26
2012-01-05 06:00:00,0,1,0,78,78
2012-01-05 07:00:00,0,1,3,212,215
2012-01-05 08:00:00,0,1,11,377,388
2012-01-05 09:00:00,0,1,7,220,227
2012-01-05 10:00:00,0,1,5,81,86
2012-01-05 11:00:00,0,1,6,78,84
2012-01-05 12:00:00,0,1,6,114,120
2012-01-05 13:00:00,0,1,6,112,118
2012-01-05 14:00:00,0,1,13,104,117
2012-01-05 15:00:00,0,1,6,113,119
2012-01-05 16:00:00,0,1,19,178,197
2012-01-05 17:00:00,0,1,19,393,412
2012-01-05 18:00:00,0,1,9,374,383
2012-01-05 19:00:00,0,1,10,255,265
2012-01-05 20:00:00,0,1,5,172,177
2012-01-05 21:00:00,0,1,9,88,97
2012-01-05 22:00:00,0,1,1,70,71
2012-01-05 23:00:00,0,1,4,56,60
2012-01-06 00:00:00,0,1,1,24,25
2012-01-06 01:00:00,0,1,2,6,8
2012-01-06 02:00:00,0,1,2,3,5
2012-01-06 03:00:00,0,1,1,3,4
2012-01-06 04:00:00,0,1,0,3,3
2012-01-06 05:00:00,0,1,0,13,13
2012-01-06 06:00:00,0,1,1,69,70
2012-01-06 07:00:00,0,1,4,201,205
2012-01-06 08:00:00,0,1,11,436,447
2012-01-06 09:00:00,0,1,4,237,241
2012-01-06 10:00:00,0,1,14,102,116
2012-01-06 11:00:00,0,1,8,130,138
2012-01-06 12:00:00,0,1,23,168,191
2012-01-06 13:00:00,0,1,16,188,204
2012-01-06 14:00:00,0,1,26,152,178
2012-01-06 15:00:00,0,1,44,178,222
2012-01-06 16:00:00,0,1,35,259,294
2012-01-06 17:00:00,0,1,20,456,476
2012-01-06 18:00:00,0,1,28,391,419
2012-01-06 19:00:00,0,1,11,261,272
2012-01-06 20:00:00,0,1,14,163,177
2012-01-06 21:00:00,0,1,17,137,154
2012-01-06 22:00:00,0,1,12,123,135
2012-01-06 23:00:00,0,1,13,88,101
2012-01-07 00:00:00,0,0,2,77,79
2012-01-07 01:00:00,0,0,6,56,62
2012-01-07 02:00:00,0,0,2,36,38
2012-01-07 03:00:00,0,0,1,19,20
2012-01-07 04:00:00,0,0,1,9,10
2012-01-07 05:00:00,0,0,2,7,9
2012-01-07 06:00:00,0,0,0,7,7
2012-01-07 07:00:00,0,0,0,20,20
2012-01-07 08:00:00,0,0,0,64,64
2012-01-07 09:00:00,0,0,14,116,130
2012-01-07 10:00:00,0,0,43,160,203
2012-01-07 11:00:00,0,0,74,250,324
2012-01-07 12:00:00,0,0,100,276,376
2012-01-07 13:00:00,0,0,149,296,445
2012-01-07 14:00:00,0,0,156,356,512
2012-01-07 15:00:00,0,0,132,317,449
2012-01-07 16:00:00,0,0,133,268,401
2012-01-07 17:00:00,0,0,87,235,322
2012-01-07 18:00:00,0,0,49,248,297
2012-01-07 19:00:00,0,0,44,171,215
2012-01-07 20:00:00,0,0,21,149,170
2012-01-07 21:00:00,0,0,22,118,140
2012-01-07 22:00:00,0,0,16,93,109
2012-01-07 23:00:00,0,0,16,103,119
2012-01-08 00:00:00,0,0,14,77,91
2012-01-08 01:00:00,0,0,10,62,72
2012-01-08 02:00:00,0,0,10,57,67
2012-01-08 03:00:00,0,0,6,26,32
2012-01-08 04:00:00,0,0,2,4,6
2012-01-08 05:00:00,0,0,0,2,2
2012-01-08 06:00:00,0,0,0,2,2
2012-01-08 07:00:00,0,0,1,23,24
2012-01-08 08:00:00,0,0,4,53,57
2012-01-08 09:00:00,0,0,23,102,125
2012-01-08 10:00:00,0,0,27,181,208
2012-01-08 11:00:00,0,0,55,201,256
2012-01-08 12:00:00,0,0,78,273,351
2012-01-08 13:00:00,0,0,77,266,343
2012-01-08 14:00:00,0,0,75,253,328
2012-01-08 15:00:00,0,0,89,241,330
2012-01-08 16:00:00,0,0,58,256,314
2012-01-08 17:00:00,0,0,22,197,219
2012-01-08 18:00:00,0,0,19,162,181
2012-01-08 19:00:00,0,0,8,104,112
2012-01-08 20:00:00,0,0,7,119,126
2012-01-08 21:00:00,0,0,10,81,91
2012-01-08 22:00:00,0,0,4,54,58
2012-01-08 23:00:00,0,0,0,30,30
2012-01-09 00:00:00,0,1,3,12,15
2012-01-09 01:00:00,0,1,1,4,5
2012-01-09 02:00:00,0,1,2,3,5
2012-01-09 03:00:00,0,1,0,3,3
2012-01-09 04:00:00,0,1,0,4,4
2012-01-09 05:00:00,0,1,0,21,21
2012-01-09 06:00:00,0,1,3,85,88
2012-01-09 07:00:00,0,1,1,239,240
2012-01-09 08:00:00,0,1,13,407,420
2012-01-09 09:00:00,0,1,9,188,197
2012-01-09 10:00:00,0,1,13,95,108
2012-01-09 11:00:00,0,1,6,82,88
2012-01-09 12:00:00,0,1,10,93,103
2012-01-09 13:00:00,0,1,3,77,80
2012-01-09 14:00:00,0,1,5,45,50
2012-01-09 15:00:00,0,1,5,64,69
2012-01-09 16:00:00,0,1,3,46,49
2012-01-09 17:00:00,0,1,5,147,152
2012-01-09 18:00:00,0,1,6,158,164
2012-01-09 19:00:00,0,1,3,187,190
2012-01-09 20:00:00,0,1,5,127,132
2012-01-09 21:00:00,0,1,1,78,79
2012-01-09 22:00:00,0,1,8,54,62
2012-01-09 23:00:00,0,1,1,51,52
2012-01-10 00:00:00,0,1,0,14,14
2012-01-10 01:00:00,0,1,2,3,5
2012-01-10 02:00:00,0,1,2,2,4
2012-01-10 04:00:00,0,1,0,4,4
2012-01-10 05:00:00,0,1,0,23,23
2012-01-10 06:00:00,0,1,0,79,79
2012-01-10 07:00:00,0,1,3,219,222
2012-01-10 08:00:00,0,1,6,465,471
2012-01-10 09:00:00,0,1,11,184,195
2012-01-10 10:00:00,0,1,3,80,83
2012-01-10 11:00:00,0,1,8,93,101
2012-01-10 12:00:00,0,1,13,127,140
2012-01-10 13:00:00,0,1,15,163,178
2012-01-10 14:00:00,0,1,10,96,106
2012-01-10 15:00:00,0,1,17,119,136
2012-01-10 16:00:00,0,1,15,225,240
2012-01-10 17:00:00,0,1,14,446,460
2012-01-10 18:00:00,0,1,13,372,385
2012-01-10 19:00:00,0,1,11,270,281
2012-01-10 20:00:00,0,1,10,190,200
2012-01-10 21:00:00,0,1,7,109,116
2012-01-10 22:00:00,0,1,10,104,114
2012-01-10 23:00:00,0,1,3,38,41
2012-01-11 00:00:00,0,1,2,26,28
2012-01-11 01:00:00,0,1,1,6,7
2012-01-11 02:00:00,0,1,0,5,5
2012-01-11 03:00:00,0,1,0,4,4
2012-01-11 04:00:00,0,1,0,2,2
2012-01-11 05:00:00,0,1,0,22,22
2012-01-11 06:00:00,0,1,2,72,74
2012-01-11 07:00:00,0,1,9,247,256
2012-01-11 08:00:00,0,1,11,488,499
2012-01-11 09:00:00,0,1,7,218,225
2012-01-11 10:00:00,0,1,13,84,97
2012-01-11 11:00:00,0,1,9,90,99
2012-01-11 12:00:00,0,1,4,51,55
2012-01-11 13:00:00,0,1,8,57,65
2012-01-11 14:00:00,0,1,3,70,73
2012-01-11 15:00:00,0,1,6,73,79
2012-01-11 16:00:00,0,1,6,112,118
2012-01-11 17:00:00,0,1,6,128,134
2012-01-11 18:00:00,0,1,2,96,98
2012-01-11 19:00:00,0,1,1,92,93
2012-01-11 20:00:00,0,1,2,55,57
2012-01-11 21:00:00,0,1,0,29,29
2012-01-11 22:00:00,0,1,0,49,49
2012-01-11 23:00:00,0,1,0,9,9
2012-01-12 00:00:00,0,1,0,3,3
2012-01-12 01:00:00,0,1,0,3,3
2012-01-12 02:00:00,0,1,1,1,2
2012-01-12 03:00:00,0,1,0,3,3
2012-01-12 04:00:00,0,1,0,2,2
2012-01-12 05:00:00,0,1,0,16,16
2012-01-12 06:00:00,0,1,1,88,89
2012-01-12 07:00:00,0,1,2,218,220
2012-01-12 08:00:00,0,1,11,497,508
2012-01-12 09:00:00,0,1,10,220,230
2012-01-12 10:00:00,0,1,6,84,90
2012-01-12 11:00:00,0,1,18,101,119
2012-01-12 12:00:00,0,1,14,130,144
2012-01-12 13:00:00,0,1,13,170,183
2012-01-12 14:00:00,0,1,24,132,156
2012-01-12 15:00:00,0,1,32,156,188
2012-01-12 16:00:00,0,1,33,248,281
2012-01-12 17:00:00,0,1,23,472,495
2012-01-12 18:00:00,0,1,22,399,421
2012-01-12 19:00:00,0,1,17,313,330
2012-01-12 20:00:00,0,1,11,229,240
2012-01-12 21:00:00,0,1,12,162,174
2012-01-12 22:00:00,0,1,12,121,133
2012-01-12 23:00:00,0,1,7,60,67
2012-01-13 00:00:00,0,1,4,38,42
2012-01-13 01:00:00,0,1,0,12,12
2012-01-13 02:00:00,0,1,1,13,14
2012-01-13 03:00:00,0,1,3,4,7
2012-01-13 04:00:00,0,1,1,2,3
2012-01-13 05:00:00,0,1,0,21,21
2012-01-13 06:00:00,0,1,2,71,73
2012-01-13 07:00:00,0,1,3,174,177
2012-01-13 08:00:00,0,1,11,408,419
2012-01-13 09:00:00,0,1,10,204,214
2012-01-13 10:00:00,0,1,2,101,103
2012-01-13 11:00:00,0,1,12,102,114
2012-01-13 12:00:00,0,1,14,140,154
2012-01-13 13:00:00,0,1,14,140,154
2012-01-13 14:00:00,0,1,10,119,129
2012-01-13 15:00:00,0,1,15,123,138
2012-01-13 16:00:00,0,1,18,215,233
2012-01-13 17:00:00,0,1,15,317,332
2012-01-13 18:00:00,0,1,7,294,301
2012-01-13 19:00:00,0,1,7,199,206
2012-01-13 20:00:00,0,1,6,130,136
2012-01-13 21:00:00,0,1,7,95,102
2012-01-13 22:00:00,0,1,7,58,65
2012-01-13 23:00:00,0,1,5,60,65
2012-01-14 00:00:00,0,0,2,42,44
2012-01-14 01:00:00,0,0,6,44,50
2012-01-14 02:00:00,0,0,6,32,38
2012-01-14 03:00:00,0,0,6,14,20
2012-01-14 04:00:00,0,0,0,3,3
2012-01-14 05:00:00,0,0,0,4,4
2012-01-14 06:00:00,0,0,0,5,5
2012-01-14 07:00:00,0,0,0,24,24
2012-01-14 08:00:00,0,0,3,89,92
2012-01-14 09:00:00,0,0,3,78,81
2012-01-14 10:00:00,0,0,14,135,149
2012-01-14 11:00:00,0,0,28,150,178
2012-01-14 12:00:00,0,0,30,189,219
2012-01-14 13:00:00,0,0,38,182,220
2012-01-14 14:00:00,0,0,52,179,231
2012-01-14 15:00:00,0,0,49,177,226
2012-01-14 16:00:00,0,0,28,178,206
2012-01-14 17:00:00,0,0,15,129,144
2012-01-14 18:00:00,0,0,21,122,143
2012-01-14 19:00:00,0,0,12,90,102
2012-01-14 20:00:00,0,0,8,95,103
2012-01-14 21:00:00,0,0,3,66,69
2012-01-14 22:00:00,0,0,4,62,66
2012-01-14 23:00:00,0,0,5,71,76
2012-01-15 00:00:00,0,0,9,50,59
2012-01-15 01:00:00,0,0,2,40,42
2012-01-15 02:00:00,0,0,5,38,43
2012-01-15 03:00:00,0,0,1,24,25
2012-01-15 04:00:00,0,0,1,5,6
2012-01-15 05:00:00,0,0,0,5,5
2012-01-15 06:00:00,0,0,1,7,8
2012-01-15 07:00:00,0,0,3,14,17
2012-01-15 08:00:00,0,0,2,34,36
2012-01-15 09:00:00,0,0,10,80,90
2012-01-15 10:00:00,0,0,11,115,126
2012-01-15 11:00:00,0,0,21,144,165
2012-01-15 12:00:00,0,0,42,192,234
2012-01-15 13:00:00,0,0,40,184,224
2012-01-15 14:00:00,0,0,25,163,188
2012-01-15 15:00:00,0,0,33,173,206
2012-01-15 16:00:00,0,0,31,174,205
2012-01-15 17:00:00,0,0,15,131,146
2012-01-15 18:00:00,0,0,7,113,120
2012-01-15 19:00:00,0,0,9,101,110
2012-01-15 20:00:00,0,0,10,85,95
2012-01-15 21:00:00,0,0,1,71,72
2012-01-15 22:00:00,0,0,2,58,60
2012-01-15 23:00:00,0,0,3,26,29
2012-01-16 00:00:00,1,0,2,23,25
2012-01-16 01:00:00,1,0,2,18,20
2012-01-16 02:00:00,1,0,3,14,17
2012-01-16 03:00:00,1,0,0,3,3
2012-01-16 04:00:00,1,0,2,6,8
2012-01-16 05:00:00,1,0,1,5,6
2012-01-16 06:00:00,1,0,0,13,13
2012-01-16 07:00:00,1,0,5,28,33
2012-01-16 08:00:00,1,0,3,75,78
2012-01-16 09:00:00,1,0,7,89,96
2012-01-16 10:00:00,1,0,19,107,126
2012-01-16 11:00:00,1,0,21,158,179
2012-01-16 12:00:00,1,0,20,165,185
2012-01-16 13:00:00,1,0,26,202,228
2012-01-16 14:00:00,1,0,23,158,181
2012-01-16 15:00:00,1,0,17,175,192
2012-01-16 16:00:00,1,0,22,158,180
2012-01-16 17:00:00,1,0,19,174,193
2012-01-16 18:00:00,1,0,6,175,181
2012-01-16 19:00:00,1,0,10,134,144
2012-01-16 20:00:00,1,0,2,88,90
2012-01-16 21:00:00,1,0,3,46,49
2012-01-16 22:00:00,1,0,4,39,43
2012-01-16 23:00:00,1,0,0,28,28
2012-01-17 00:00:00,0,1,0,12,12
2012-01-17 01:00:00,0,1,0,2,2
2012-01-17 02:00:00,0,1,0,12,12
2012-01-17 04:00:00,0,1,0,2,2
2012-01-17 05:00:00,0,1,0,13,13
2012-01-17 06:00:00,0,1,0,57,57
2012-01-17 07:00:00,0,1,5,121,126
2012-01-17 08:00:00,0,1,3,90,93
2012-01-17 09:00:00,0,1,7,61,68
2012-01-17 10:00:00,0,1,1,61,62
2012-01-17 11:00:00,0,1,2,73,75
2012-01-17 12:00:00,0,1,3,83,86
2012-01-17 13:00:00,0,1,8,95,103
2012-01-17 14:00:00,0,1,12,120,132
2012-01-17 15:00:00,0,1,6,123,129
2012-01-17 16:00:00,0,1,14,205,219
2012-01-17 17:00:00,0,1,20,442,462
2012-01-17 18:00:00,0,1,12,451,463
2012-01-17 19:00:00,0,1,11,297,308
2012-01-17 20:00:00,0,1,11,169,180
2012-01-17 21:00:00,0,1,6,174,180
2012-01-17 22:00:00,0,1,5,85,90
2012-01-17 23:00:00,0,1,1,60,61
2012-01-18 00:00:00,0,1,3,14,17
2012-01-18 01:00:00,0,1,0,10,10
2012-01-18 02:00:00,0,1,1,1,2
2012-01-18 03:00:00,0,1,1,3,4
2012-01-18 04:00:00,0,1,0,1,1
2012-01-18 05:00:00,0,1,0,29,29
2012-01-18 06:00:00,0,1,0,88,88
2012-01-18 07:00:00,0,1,1,262,263
2012-01-18 08:00:00,0,1,15,474,489
2012-01-18 09:00:00,0,1,6,196,202
2012-01-18 10:00:00,0,1,5,88,93
2012-01-18 11:00:00,0,1,4,110,114
2012-01-18 12:00:00,0,1,6,155,161
2012-01-18 13:00:00,0,1,6,124,130
2012-01-18 14:00:00,0,1,7,98,105
2012-01-18 15:00:00,0,1,8,122,130
2012-01-18 16:00:00,0,1,13,163,176
2012-01-18 17:00:00,0,1,8,338,346
2012-01-18 18:00:00,0,1,8,347,355
2012-01-18 19:00:00,0,1,5,251,256
2012-01-18 20:00:00,0,1,1,164,165
2012-01-18 21:00:00,0,1,5,119,124
2012-01-18 22:00:00,0,1,4,74,78
2012-01-18 23:00:00,0,1,2,36,38
2012-01-19 00:00:00,0,1,0,16,16
2012-01-19 01:00:00,0,1,0,5,5
2012-01-19 02:00:00,0,1,0,3,3
2012-01-19 03:00:00,0,1,0,4,4
2012-01-19 04:00:00,0,1,0,1,1
2012-01-19 05:00:00,0,1,0,19,19
2012-01-19 06:00:00,0,1,0,86,86
2012-01-19 07:00:00,0,1,2,204,206
2012-01-19 08:00:00,0,1,9,414,423
2012-01-19 09:00:00,0,1,6,204,210
2012-01-19 10:00:00,0,1,10,98,108
2012-01-19 11:00:00,0,1,6,93,99
2012-01-19 12:00:00,0,1,5,106,111
2012-01-19 13:00:00,0,1,6,118,124
2012-01-19 14:00:00,0,1,15,104,119
2012-01-19 15:00:00,0,1,9,118,127
2012-01-19 16:00:00,0,1,8,185,193
2012-01-19 17:00:00,0,1,21,364,385
2012-01-19 18:00:00,0,1,16,345,361
2012-01-19 19:00:00,0,1,5,229,234
2012-01-19 20:00:00,0,1,7,184,191
2012-01-19 21:00:00,0,1,4,117,121
2012-01-19 22:00:00,0,1,0,90,90
2012-01-19 23:00:00,0,1,1,55,56
2012-02-01 00:00:00,0,1,0,31,31
2012-02-01 01:00:00,0,1,0,4,4
2012-02-01 02:00:00,0,1,1,6,7
2012-02-01 03:00:00,0,1,0,3,3
2012-02-01 04:00:00,0,1,0,1,1
2012-02-01 05:00:00,0,1,0,18,18
2012-02-01 06:00:00,0,1,0,67,67
2012-02-01 07:00:00,0,1,7,201,208
2012-02-01 08:00:00,0,1,15,505,520
2012-02-01 09:00:00,0,1,9,267,276
2012-02-01 10:00:00,0,1,9,124,133
2012-02-01 11:00:00,0,1,27,116,143
2012-02-01 12:00:00,0,1,26,153,179
2012-02-01 13:00:00,0,1,12,174,186
2012-02-01 14:00:00,0,1,33,159,192
2012-02-01 15:00:00,0,1,25,169,194
2012-02-01 16:00:00,0,1,22,261,283
2012-02-01 17:00:00,0,1,31,508,539
2012-02-01 18:00:00,0,1,12,514,526
2012-02-01 19:00:00,0,1,20,315,335
2012-02-01 20:00:00,0,1,10,254,264
2012-02-01 21:00:00,0,1,16,217,233
2012-02-01 22:00:00,0,1,7,133,140
2012-02-01 23:00:00,0,1,22,75,97
2012-02-02 00:00:00,0,1,7,24,31
2012-02-02 01:00:00,0,1,3,14,17
2012-02-02 02:00:00,0,1,2,7,9
2012-02-02 03:00:00,0,1,0,2,2
2012-02-02 04:00:00,0,1,0,1,1
2012-02-02 05:00:00,0,1,0,19,19
2012-02-02 06:00:00,0,1,1,73,74
2012-02-02 07:00:00,0,1,4,201,205
2012-02-02 08:00:00,0,1,9,436,445
2012-02-02 09:00:00,0,1,15,213,228
2012-02-02 10:00:00,0,1,6,72,78
2012-02-02 11:00:00,0,1,6,99,105
2012-02-02 12:00:00,0,1,8,140,148
2012-02-02 13:00:00,0,1,13,124,137
2012-02-02 14:00:00,0,1,12,129,141
2012-02-02 15:00:00,0,1,24,150,174
2012-02-02 16:00:00,0,1,18,211,229
2012-02-02 17:00:00,0,1,13,437,450
2012-02-02 18:00:00,0,1,17,393,410
2012-02-02 19:00:00,0,1,16,311,327
2012-02-02 20:00:00,0,1,9,204,213
2012-02-02 21:00:00,0,1,4,144,148
2012-02-02 22:00:00,0,1,3,106,109
2012-02-02 23:00:00,0,1,0,61,61
2012-02-03 00:00:00,0,1,1,37,38
2012-02-03 01:00:00,0,1,3,19,22
2012-02-03 02:00:00,0,1,0,6,6
2012-02-03 03:00:00,0,1,0,4,4
2012-02-03 04:00:00,0,1,0,2,2
2012-02-03 05:00:00,0,1,0,17,17
2012-02-03 06:00:00,0,1,0,88,88
2012-02-03 07:00:00,0,1,10,216,226
2012-02-03 08:00:00,0,1,12,429,441
2012-02-03 09:00:00,0,1,18,252,270
2012-02-03 10:00:00,0,1,15,114,129
2012-02-03 11:00:00,0,1,15,149,164
2012-02-03 12:00:00,0,1,25,191,216
2012-02-03 13:00:00,0,1,25,173,198
2012-02-03 14:00:00,0,1,22,148,170
2012-02-03 15:00:00,0,1,48,168,216
2012-02-03 16:00:00,0,1,36,275,311
2012-02-03 17:00:00,0,1,30,458,488
2012-02-03 18:00:00,0,1,17,368,385
2012-02-03 19:00:00,0,1,11,256,267
2012-02-03 20:00:00,0,1,8,155,163
2012-02-03 21:00:00,0,1,8,126,134
2012-02-03 22:00:00,0,1,3,116,119
2012-02-03 23:00:00,0,1,3,74,77
2012-02-04 00:00:00,0,0,10,76,86
2012-02-04 01:00:00,0,0,0,43,43
2012-02-04 02:00:00,0,0,6,38,44
2012-02-04 03:00:00,0,0,1,17,18
2012-02-04 04:00:00,0,0,1,5,6
2012-02-04 05:00:00,0,0,1,3,4
2012-02-04 06:00:00,0,0,1,4,5
2012-02-04 07:00:00,0,0,1,27,28
2012-02-04 08:00:00,0,0,4,86,90
2012-02-04 09:00:00,0,0,16,141,157
2012-02-04 10:00:00,0,0,31,193,224
2012-02-04 11:00:00,0,0,46,224,270
2012-02-04 12:00:00,0,0,40,260,300
2012-02-04 13:00:00,0,0,58,244,302
2012-02-04 14:00:00,0,0,47,229,276
2012-02-04 15:00:00,0,0,61,244,305
2012-02-04 16:00:00,0,0,20,123,143
2012-02-04 17:00:00,0,0,13,54,67
2012-02-04 18:00:00,0,0,6,58,64
2012-02-04 19:00:00,0,0,5,75,80
2012-02-04 20:00:00,0,0,4,73,77
2012-02-04 21:00:00,0,0,4,74,78
2012-02-04 22:00:00,0,0,4,91,95
2012-02-04 23:00:00,0,0,4,66,70
2012-02-05 00:00:00,0,0,3,58,61
2012-02-05 01:00:00,0,0,5,46,51
2012-02-05 02:00:00,0,0,4,59,63
2012-02-05 03:00:00,0,0,4,13,17
2012-02-05 04:00:00,0,0,0,9,9
2012-02-05 05:00:00,0,0,0,4,4
2012-02-05 06:00:00,0,0,0,4,4
2012-02-05 07:00:00,0,0,0,16,16
2012-02-05 08:00:00,0,0,4,58,62
2012-02-05 09:00:00,0,0,9,83,92
2012-02-05 10:00:00,0,0,10,138,148
2012-02-05 11:00:00,0,0,22,160,182
2012-02-05 12:00:00,0,0,25,223,248
2012-02-05 13:00:00,0,0,33,241,274
2012-02-05 14:00:00,0,0,40,203,243
2012-02-05 15:00:00,0,0,55,217,272
2012-02-05 16:00:00,0,0,35,261,296
2012-02-05 17:00:00,0,0,31,275,306
2012-02-05 18:00:00,0,0,10,171,181
2012-02-05 19:00:00,0,0,6,63,69
2012-02-05 20:00:00,0,0,3,47,50
2012-02-05 21:00:00,0,0,6,60,66
2012-02-05 22:00:00,0,0,9,182,191
2012-02-05 23:00:00,0,0,4,38,42
2012-02-06 00:00:00,0,1,7,14,21
2012-02-06 01:00:00,0,1,0,6,6
2012-02-06 02:00:00,0,1,0,3,3
2012-02-06 04:00:00,0,1,0,2,2
2012-02-06 05:00:00,0,1,0,17,17
2012-02-06 06:00:00,0,1,0,72,72
2012-02-06 07:00:00,0,1,5,229,234
2012-02-06 08:00:00,0,1,10,434,444
2012-02-06 09:00:00,0,1,8,269,277
2012-02-06 10:00:00,0,1,20,96,116
2012-02-06 11:00:00,0,1,12,104,116
2012-02-06 12:00:00,0,1,19,131,150
2012-02-06 13:00:00,0,1,17,124,141
2012-02-06 14:00:00,0,1,14,126,140
2012-02-06 15:00:00,0,1,25,146,171
2012-02-06 16:00:00,0,1,13,215,228
2012-02-06 17:00:00,0,1,13,417,430
2012-02-06 18:00:00,0,1,11,426,437
2012-02-06 19:00:00,0,1,7,284,291
2012-02-06 20:00:00,0,1,7,194,201
2012-02-06 21:00:00,0,1,11,143,154
2012-02-06 22:00:00,0,1,4,83,87
2012-02-06 23:00:00,0,1,3,43,46
2012-02-07 00:00:00,0,1,1,22,23
2012-02-07 01:00:00,0,1,8,6,14
2012-02-07 02:00:00,0,1,0,4,4
2012-02-07 03:00:00,0,1,1,1,2
2012-02-07 04:00:00,0,1,0,3,3
2012-02-07 05:00:00,0,1,0,15,15
2012-02-07 06:00:00,0,1,2,98,100
2012-02-07 07:00:00,0,1,6,293,299
2012-02-07 08:00:00,0,1,7,522,529
2012-02-07 09:00:00,0,1,11,278,289
2012-02-07 10:00:00,0,1,12,104,116
2012-02-07 11:00:00,0,1,9,120,129
2012-02-07 12:00:00,0,1,9,163,172
2012-02-07 13:00:00,0,1,15,169,184
2012-02-07 14:00:00,0,1,11,127,138
2012-02-07 15:00:00,0,1,13,133,146
2012-02-07 16:00:00,0,1,19,257,276
2012-02-07 17:00:00,0,1,15,494,509
2012-02-07 18:00:00,0,1,10,508,518
2012-02-07 19:00:00,0,1,11,327,338
2012-02-07 20:00:00,0,1,6,206,212
2012-02-07 21:00:00,0,1,20,170,190
2012-02-07 22:00:00,0,1,11,107,118
2012-02-07 23:00:00,0,1,2,49,51
2012-02-08 00:00:00,0,1,2,21,23
2012-02-08 01:00:00,0,1,1,9,10
2012-02-08 02:00:00,0,1,0,1,1
2012-02-08 03:00:00,0,1,0,1,1
2012-02-08 04:00:00,0,1,0,1,1
2012-02-08 05:00:00,0,1,0,20,20
2012-02-08 06:00:00,0,1,3,95,98
2012-02-08 07:00:00,0,1,5,276,281
2012-02-08 08:00:00,0,1,13,495,508
2012-02-08 09:00:00,0,1,8,245,253
2012-02-08 10:00:00,0,1,1,107,108
2012-02-08 11:00:00,0,1,5,97,102
2012-02-08 12:00:00,0,1,14,124,138
2012-02-08 13:00:00,0,1,15,111,126
2012-02-08 14:00:00,0,1,8,100,108
2012-02-08 15:00:00,0,1,5,49,54
2012-02-08 16:00:00,0,1,2,73,75
2012-02-08 17:00:00,0,1,8,147,155
2012-02-08 18:00:00,0,1,4,163,167
2012-02-08 19:00:00,0,1,3,158,161
2012-02-08 20:00:00,0,1,3,122,125
2012-02-08 21:00:00,0,1,3,126,129
2012-02-08 22:00:00,0,1,3,95,98
2012-02-08 23:00:00,0,1,3,57,60
2012-02-09 00:00:00,0,1,3,23,26
2012-02-09 01:00:00,0,1,2,10,12
2012-02-09 02:00:00,0,1,0,2,2
2012-02-09 03:00:00,0,1,0,4,4
2012-02-09 04:00:00,0,1,0,1,1
2012-02-09 05:00:00,0,1,0,18,18
2012-02-09 06:00:00,0,1,1,75,76
2012-02-09 07:00:00,0,1,4,263,267
2012-02-09 08:00:00,0,1,11,473,484
2012-02-09 09:00:00,0,1,9,229,238
2012-02-09 10:00:00,0,1,7,90,97
2012-02-09 11:00:00,0,1,4,95,99
2012-02-09 12:00:00,0,1,10,148,158
2012-02-09 13:00:00,0,1,10,144,154
2012-02-09 14:00:00,0,1,18,126,144
2012-02-09 15:00:00,0,1,14,120,134
2012-02-09 16:00:00,0,1,15,223,238
2012-02-09 17:00:00,0,1,12,387,399
2012-02-09 18:00:00,0,1,13,404,417
2012-02-09 19:00:00,0,1,8,287,295
2012-02-09 20:00:00,0,1,2,197,199
2012-02-09 21:00:00,0,1,8,169,177
2012-02-09 22:00:00,0,1,3,104,107
2012-02-09 23:00:00,0,1,9,75,84
2012-02-10 00:00:00,0,1,4,39,43
2012-02-10 01:00:00,0,1,2,11,13
2012-02-10 02:00:00,0,1,7,9,16
2012-02-10 03:00:00,0,1,0,5,5
2012-02-10 04:00:00,0,1,0,2,2
2012-02-10 05:00:00,0,1,0,17,17
2012-02-10 06:00:00,0,1,3,61,64
2012-02-10 07:00:00,0,1,5,225,230
2012-02-10 08:00:00,0,1,1,447,448
2012-02-10 09:00:00,0,1,10,265,275
2012-02-10 10:00:00,0,1,5,119,124
2012-02-10 11:00:00,0,1,19,134,153
2012-02-10 12:00:00,0,1,8,168,176
2012-02-10 13:00:00,0,1,22,170,192
2012-02-10 14:00:00,0,1,8,138,146
2012-02-10 15:00:00,0,1,27,164,191
2012-02-10 16:00:00,0,1,28,240,268
2012-02-10 17:00:00,0,1,15,381,396
2012-02-10 18:00:00,0,1,14,345,359
2012-02-10 19:00:00,0,1,16,246,262
2012-02-10 20:00:00,0,1,7,144,151
2012-02-10 21:00:00,0,1,14,108,122
2012-02-10 22:00:00,0,1,11,102,113
2012-02-10 23:00:00,0,1,1,64,65
2012-02-11 00:00:00,0,0,3,50,53
2012-02-11 01:00:00,0,0,2,43,45
2012-02-11 02:00:00,0,0,2,24,26
2012-02-11 03:00:00,0,0,0,9,9
2012-02-11 04:00:00,0,0,0,4,4
2012-02-11 05:00:00,0,0,0,2,2
2012-02-11 06:00:00,0,0,1,8,9
2012-02-11 07:00:00,0,0,0,19,19
2012-02-11 08:00:00,0,0,1,77,78
2012-02-11 09:00:00,0,0,5,85,90
2012-02-11 10:00:00,0,0,23,143,166
2012-02-11 11:00:00,0,0,26,157,183
2012-02-11 12:00:00,0,0,25,196,221
2012-02-11 13:00:00,0,0,18,217,235
2012-02-11 14:00:00,0,0,38,205,243
2012-02-11 15:00:00,0,0,12,112,124
2012-02-11 16:00:00,0,0,12,134,146
2012-02-11 17:00:00,0,0,13,131,144
2012-02-11 18:00:00,0,0,3,105,108
2012-02-11 19:00:00,0,0,2,85,87
2012-02-11 20:00:00,0,0,1,62,63
2012-02-11 21:00:00,0,0,5,43,48
2012-02-11 22:00:00,0,0,0,46,46
2012-02-11 23:00:00,0,0,0,20,20
2012-02-12 00:00:00,0,0,0,21,21
2012-02-12 01:00:00,0,0,0,24,24
2012-02-12 02:00:00,0,0,1,26,27
2012-02-12 03:00:00,0,0,0,14,14
2012-02-12 04:00:00,0,0,0,1,1
2012-02-12 05:00:00,0,0,0,3,3
2012-02-12 06:00:00,0,0,0,2,2
2012-02-12 07:00:00,0,0,0,18,18
2012-02-12 08:00:00,0,0,0,26,26
2012-02-12 09:00:00,0,0,3,60,63
2012-02-12 10:00:00,0,0,8,83,91
2012-02-12 11:00:00,0,0,3,121,124
2012-02-12 12:00:00,0,0,7,133,140
2012-02-12 13:00:00,0,0,10,128,138
2012-02-12 14:00:00,0,0,9,102,111
2012-02-12 15:00:00,0,0,5,150,155
2012-02-12 16:00:00,0,0,16,148,164
2012-02-12 17:00:00,0,0,4,83,87
2012-02-12 18:00:00,0,0,4,92,96
2012-02-12 19:00:00,0,0,2,78,80
2012-02-12 20:00:00,0,0,1,56,57
2012-02-12 21:00:00,0,0,0,36,36
2012-02-12 22:00:00,0,0,0,28,28
2012-02-12 23:00:00,0,0,0,23,23
2012-02-13 00:00:00,0,1,0,9,9
2012-02-13 01:00:00,0,1,0,6,6
2012-02-13 02:00:00,0,1,0,4,4
2012-02-13 03:00:00,0,1,0,1,1
2012-02-13 04:00:00,0,1,0,2,2
2012-02-13 05:00:00,0,1,0,17,17
2012-02-13 06:00:00,0,1,1,71,72
2012-02-13 07:00:00,0,1,1,194,195
2012-02-13 08:00:00,0,1,4,413,417
2012-02-13 09:00:00,0,1,7,198,205
2012-02-13 10:00:00,0,1,1,70,71
2012-02-13 11:00:00,0,1,5,85,90
2012-02-13 12:00:00,0,1,7,111,118
2012-02-13 13:00:00,0,1,11,129,140
2012-02-13 14:00:00,0,1,10,125,135
2012-02-13 15:00:00,0,1,10,145,155
2012-02-13 16:00:00,0,1,5,206,211
2012-02-13 17:00:00,0,1,8,399,407
2012-02-13 18:00:00,0,1,6,399,405
2012-02-13 19:00:00,0,1,7,256,263
2012-02-13 20:00:00,0,1,4,210,214
2012-02-13 21:00:00,0,1,2,145,147
2012-02-13 22:00:00,0,1,3,99,102
2012-02-13 23:00:00,0,1,2,34,36
2012-02-14 00:00:00,0,1,0,14,14
2012-02-14 01:00:00,0,1,0,6,6
2012-02-14 02:00:00,0,1,0,3,3
2012-02-14 03:00:00,0,1,0,3,3
2012-02-14 04:00:00,0,1,0,2,2
2012-02-14 05:00:00,0,1,2,20,22
2012-02-14 06:00:00,0,1,1,89,90
2012-02-14 07:00:00,0,1,4,276,280
2012-02-14 08:00:00,0,1,3,510,513
2012-02-14 09:00:00,0,1,6,256,262
2012-02-14 10:00:00,0,1,8,90,98
2012-02-14 11:00:00,0,1,5,107,112
2012-02-14 12:00:00,0,1,10,162,172
2012-02-14 13:00:00,0,1,6,167,173
2012-02-14 14:00:00,0,1,13,111,124
2012-02-14 15:00:00,0,1,7,138,145
2012-02-14 16:00:00,0,1,15,251,266
2012-02-14 17:00:00,0,1,19,504,523
2012-02-14 18:00:00,0,1,8,398,406
2012-02-14 19:00:00,0,1,11,270,281
2012-02-14 20:00:00,0,1,6,178,184
2012-02-14 21:00:00,0,1,4,105,109
2012-02-14 22:00:00,0,1,5,72,77
2012-02-14 23:00:00,0,1,2,55,57
2012-02-15 00:00:00,0,1,0,22,22
2012-02-15 01:00:00,0,1,0,5,5
2012-02-15 02:00:00,0,1,0,4,4
2012-02-15 03:00:00,0,1,0,3,3
2012-02-15 04:00:00,0,1,0,1,1
2012-02-15 05:00:00,0,1,0,25,25
2012-02-15 06:00:00,0,1,3,92,95
2012-02-15 07:00:00,0,1,3,318,321
2012-02-15 08:00:00,0,1,7,508,515
2012-02-15 09:00:00,0,1,5,226,231
2012-02-15 10:00:00,0,1,12,108,120
2012-02-15 11:00:00,0,1,13,125,138
2012-02-15 12:00:00,0,1,11,152,163
2012-02-15 13:00:00,0,1,11,159,170
2012-02-15 14:00:00,0,1,6,128,134
2012-02-15 15:00:00,0,1,7,164,171
2012-02-15 16:00:00,0,1,9,222,231
2012-02-15 17:00:00,0,1,17,470,487
2012-02-15 18:00:00,0,1,9,459,468
2012-02-15 19:00:00,0,1,9,302,311
2012-02-15 20:00:00,0,1,4,207,211
2012-02-15 21:00:00,0,1,8,170,178
2012-02-15 22:00:00,0,1,3,104,107
2012-02-15 23:00:00,0,1,4,54,58
2012-02-16 00:00:00,0,1,1,22,23
2012-02-16 01:00:00,0,1,0,5,5
2012-02-16 02:00:00,0,1,1,6,7
2012-02-16 03:00:00,0,1,0,1,1
2012-02-16 04:00:00,0,1,0,3,3
2012-02-16 05:00:00,0,1,0,20,20
2012-02-16 06:00:00,0,1,4,83,87
2012-02-16 07:00:00,0,1,3,285,288
2012-02-16 08:00:00,0,1,9,489,498
2012-02-16 09:00:00,0,1,3,199,202
2012-02-16 10:00:00,0,1,2,42,44
2012-02-16 11:00:00,0,1,2,69,71
2012-02-16 12:00:00,0,1,1,44,45
2012-02-16 13:00:00,0,1,2,62,64
2012-02-16 14:00:00,0,1,1,30,31
2012-02-16 15:00:00,0,1,3,50,53
2012-02-16 16:00:00,0,1,8,110,118
2012-02-16 17:00:00,0,1,8,281,289
2012-02-16 18:00:00,0,1,8,345,353
2012-02-16 19:00:00,0,1,4,254,258
2012-02-16 20:00:00,0,1,5,211,216
2012-02-16 21:00:00,0,1,3,142,145
2012-02-16 22:00:00,0,1,3,108,111
2012-02-16 23:00:00,0,1,3,70,73
2012-02-17 00:00:00,0,1,2,32,34
2012-02-17 01:00:00,0,1,2,16,18
2012-02-17 02:00:00,0,1,1,11,12
2012-02-17 03:00:00,0,1,0,1,1
2012-02-17 04:00:00,0,1,0,1,1
2012-02-17 05:00:00,0,1,0,16,16
2012-02-17 06:00:00,0,1,1,70,71
2012-02-17 07:00:00,0,1,4,222,226
2012-02-17 08:00:00,0,1,4,516,520
2012-02-17 09:00:00,0,1,8,275,283
2012-02-17 10:00:00,0,1,13,103,116
2012-02-17 11:00:00,0,1,9,133,142
2012-02-17 12:00:00,0,1,21,177,198
2012-02-17 13:00:00,0,1,34,171,205
2012-02-17 14:00:00,0,1,33,137,170
2012-02-17 15:00:00,0,1,41,180,221
2012-02-17 16:00:00,0,1,56,251,307
2012-02-17 17:00:00,0,1,36,429,465
2012-02-17 18:00:00,0,1,15,362,377
2012-02-17 19:00:00,0,1,16,266,282
2012-02-17 20:00:00,0,1,13,158,171
2012-02-17 21:00:00,0,1,15,114,129
2012-02-17 22:00:00,0,1,15,92,107
2012-02-17 23:00:00,0,1,10,72,82
2012-02-18 00:00:00,0,0,5,81,86
2012-02-18 01:00:00,0,0,7,38,45
2012-02-18 02:00:00,0,0,6,39,45
2012-02-18 03:00:00,0,0,3,15,18
2012-02-18 04:00:00,0,0,3,4,7
2012-02-18 05:00:00,0,0,0,1,1
2012-02-18 06:00:00,0,0,1,8,9
2012-02-18 07:00:00,0,0,8,33,41
2012-02-18 08:00:00,0,0,10,92,102
2012-02-18 09:00:00,0,0,22,116,138
2012-02-18 10:00:00,0,0,48,157,205
2012-02-18 11:00:00,0,0,102,184,286
2012-02-18 12:00:00,0,0,128,241,369
2012-02-18 13:00:00,0,0,165,219,384
2012-02-18 14:00:00,0,0,183,244,427
2012-02-18 15:00:00,0,0,229,270,499
2012-02-18 16:00:00,0,0,186,218,404
2012-02-18 17:00:00,0,0,142,222,364
2012-02-18 18:00:00,0,0,70,176,246
2012-02-18 19:00:00,0,0,38,150,188
2012-02-18 20:00:00,0,0,25,123,148
2012-02-18 21:00:00,0,0,25,89,114
2012-02-18 22:00:00,0,0,17,101,118
2012-02-18 23:00:00,0,0,12,62,74
2012-02-19 00:00:00,0,0,9,65,74
2012-02-19 01:00:00,0,0,10,62,72
2012-02-19 02:00:00,0,0,3,45,48
2012-02-19 03:00:00,0,0,3,12,15
2012-02-19 04:00:00,0,0,0,3,3
2012-02-19 05:00:00,0,0,1,1,2
2012-02-19 06:00:00,0,0,0,5,5
2012-02-19 07:00:00,0,0,2,12,14
2012-02-19 08:00:00,0,0,8,48,56
2012-02-19 09:00:00,0,0,20,73,93
2012-02-19 10:00:00,0,0,49,142,191
2012-02-19 11:00:00,0,0,82,144,226
2012-02-19 12:00:00,0,0,71,184,255
2012-02-19 13:00:00,0,0,64,197,261
2012-02-19 14:00:00,0,0,48,189,237
2012-02-19 15:00:00,0,0,85,168,253
2012-02-19 16:00:00,0,0,62,150,212
2012-02-19 17:00:00,0,0,22,135,157
2012-02-19 18:00:00,0,0,23,144,167
2012-02-19 19:00:00,0,0,18,101,119
2012-02-19 20:00:00,0,0,22,81,103
2012-02-19 21:00:00,0,0,3,33,36
2012-02-19 22:00:00,0,0,8,47,55
2012-02-19 23:00:00,0,0,5,30,35
2012-03-01 00:00:00,0,1,1,10,11
2012-03-01 01:00:00,0,1,0,12,12
2012-03-01 02:00:00,0,1,0,6,6
2012-03-01 03:00:00,0,1,0,3,3
2012-03-01 04:00:00,0,1,0,5,5
2012-03-01 05:00:00,0,1,0,18,18
2012-03-01 06:00:00,0,1,2,107,109
2012-03-01 07:00:00,0,1,8,296,304
2012-03-01 08:00:00,0,1,15,579,594
2012-03-01 09:00:00,0,1,5,281,286
2012-03-01 10:00:00,0,1,11,122,133
2012-03-01 11:00:00,0,1,19,149,168
2012-03-01 12:00:00,0,1,16,204,220
2012-03-01 13:00:00,0,1,24,187,211
2012-03-01 14:00:00,0,1,37,174,211
2012-03-01 15:00:00,0,1,31,192,223
2012-03-01 16:00:00,0,1,38,323,361
2012-03-01 17:00:00,0,1,49,551,600
2012-03-01 18:00:00,0,1,27,498,525
2012-03-01 19:00:00,0,1,11,317,328
2012-03-01 20:00:00,0,1,12,242,254
2012-03-01 21:00:00,0,1,7,190,197
2012-03-01 22:00:00,0,1,3,123,126
2012-03-01 23:00:00,0,1,9,76,85
2012-03-02 00:00:00,0,1,1,45,46
2012-03-02 01:00:00,0,1,2,18,20
2012-03-02 02:00:00,0,1,2,4,6
2012-03-02 03:00:00,0,1,0,3,3
2012-03-02 04:00:00,0,1,0,2,2
2012-03-02 05:00:00,0,1,0,24,24
2012-03-02 06:00:00,0,1,4,88,92
2012-03-02 07:00:00,0,1,4,258,262
2012-03-02 08:00:00,0,1,16,533,549
2012-03-02 09:00:00,0,1,15,299,314
2012-03-02 10:00:00,0,1,14,118,132
2012-03-02 11:00:00,0,1,40,154,194
2012-03-02 12:00:00,0,1,40,194,234
2012-03-02 13:00:00,0,1,31,191,222
2012-03-02 14:00:00,0,1,29,176,205
2012-03-02 15:00:00,0,1,5,73,78
2012-03-02 16:00:00,0,1,1,49,50
2012-03-02 17:00:00,0,1,5,123,128
2012-03-02 18:00:00,0,1,6,154,160
2012-03-02 19:00:00,0,1,12,162,174
2012-03-02 20:00:00,0,1,7,93,100
2012-03-02 21:00:00,0,1,2,99,101
2012-03-02 22:00:00,0,1,6,69,75
2012-03-02 23:00:00,0,1,4,19,23
2012-03-03 00:00:00,0,0,1,21,22
2012-03-03 01:00:00,0,0,0,44,44
2012-03-03 02:00:00,0,0,4,34,38
2012-03-03 03:00:00,0,0,1,20,21
2012-03-03 04:00:00,0,0,0,2,2
2012-03-03 05:00:00,0,0,1,1,2
2012-03-03 06:00:00,0,0,1,6,7
2012-03-03 07:00:00,0,0,2,14,16
2012-03-03 08:00:00,0,0,2,46,48
2012-03-03 09:00:00,0,0,7,87,94
2012-03-03 10:00:00,0,0,31,137,168
2012-03-03 11:00:00,0,0,33,181,214
2012-03-03 12:00:00,0,0,47,252,299
2012-03-03 13:00:00,0,0,87,252,339
2012-03-03 14:00:00,0,0,151,279,430
2012-03-03 15:00:00,0,0,145,254,399
2012-03-03 16:00:00,0,0,167,300,467
2012-03-03 17:00:00,0,0,106,279,385
2012-03-03 18:00:00,0,0,53,250,303
2012-03-03 19:00:00,0,0,34,191,225
2012-03-03 20:00:00,0,0,28,121,149
2012-03-03 21:00:00,0,0,24,130,154
2012-03-03 22:00:00,0,0,19,115,134
2012-03-03 23:00:00,0,0,12,94,106
2012-03-04 00:00:00,0,0,5,67,72
2012-03-04 01:00:00,0,0,16,60,76
2012-03-04 02:00:00,0,0,14,66,80
2012-03-04 03:00:00,0,0,5,21,26
2012-03-04 04:00:00,0,0,3,11,14
2012-03-04 05:00:00,0,0,0,5,5
2012-03-04 06:00:00,0,0,0,5,5
2012-03-04 07:00:00,0,0,2,21,23
2012-03-04 08:00:00,0,0,12,54,66
2012-03-04 09:00:00,0,0,14,104,118
2012-03-04 10:00:00,0,0,31,161,192
2012-03-04 11:00:00,0,0,64,192,256
2012-03-04 12:00:00,0,0,71,256,327
2012-03-04 13:00:00,0,0,108,256,364
2012-03-04 14:00:00,0,0,106,226,332
2012-03-04 15:00:00,0,0,82,252,334
2012-03-04 16:00:00,0,0,68,231,299
2012-03-04 17:00:00,0,0,49,214,263
2012-03-04 18:00:00,0,0,20,164,184
2012-03-04 19:00:00,0,0,12,120,132
2012-03-04 20:00:00,0,0,8,80,88
2012-03-04 21:00:00,0,0,9,70,79
2012-03-04 22:00:00,0,0,9,53,62
2012-03-04 23:00:00,0,0,2,24,26
2012-03-05 00:00:00,0,1,2,15,17
2012-03-05 01:00:00,0,1,3,3,6
2012-03-05 02:00:00,0,1,1,3,4
2012-03-05 03:00:00,0,1,0,1,1
2012-03-05 04:00:00,0,1,0,1,1
2012-03-05 05:00:00,0,1,1,17,18
2012-03-05 06:00:00,0,1,2,89,91
2012-03-05 07:00:00,0,1,7,253,260
2012-03-05 08:00:00,0,1,13,415,428
2012-03-05 09:00:00,0,1,11,186,197
2012-03-05 10:00:00,0,1,12,74,86
2012-03-05 11:00:00,0,1,17,86,103
2012-03-05 12:00:00,0,1,15,122,137
2012-03-05 13:00:00,0,1,11,109,120
2012-03-05 14:00:00,0,1,13,115,128
2012-03-05 15:00:00,0,1,20,110,130
2012-03-05 16:00:00,0,1,30,180,210
2012-03-05 17:00:00,0,1,11,376,387
2012-03-05 18:00:00,0,1,12,363,375
2012-03-05 19:00:00,0,1,6,220,226
2012-03-05 20:00:00,0,1,8,171,179
2012-03-05 21:00:00,0,1,4,116,120
2012-03-05 22:00:00,0,1,2,76,78
2012-03-05 23:00:00,0,1,2,29,31
2012-03-06 00:00:00,0,1,0,8,8
2012-03-06 01:00:00,0,1,0,6,6
2012-03-06 02:00:00,0,1,0,4,4
2012-03-06 03:00:00,0,1,0,1,1
2012-03-06 04:00:00,0,1,0,3,3
2012-03-06 05:00:00,0,1,0,25,25
2012-03-06 06:00:00,0,1,3,99,102
2012-03-06 07:00:00,0,1,5,270,275
2012-03-06 08:00:00,0,1,14,487,501
2012-03-06 09:00:00,0,1,11,222,233
2012-03-06 10:00:00,0,1,16,113,129
2012-03-06 11:00:00,0,1,20,110,130
2012-03-06 12:00:00,0,1,9,129,138
2012-03-06 13:00:00,0,1,16,148,164
2012-03-06 14:00:00,0,1,20,116,136
2012-03-06 15:00:00,0,1,24,142,166
2012-03-06 16:00:00,0,1,22,228,250
2012-03-06 17:00:00,0,1,21,425,446
2012-03-06 18:00:00,0,1,15,442,457
2012-03-06 19:00:00,0,1,9,278,287
2012-03-06 20:00:00,0,1,3,184,187
2012-03-06 21:00:00,0,1,5,143,148
2012-03-06 22:00:00,0,1,5,101,106
2012-03-06 23:00:00,0,1,3,51,54
2012-03-07 00:00:00,0,1,3,12,15
2012-03-07 01:00:00,0,1,1,4,5
2012-03-07 02:00:00,0,1,0,4,4
2012-03-07 03:00:00,0,1,1,2,3
2012-03-07 04:00:00,0,1,0,3,3
2012-03-07 05:00:00,0,1,0,18,18
2012-03-07 06:00:00,0,1,4,104,108
2012-03-07 07:00:00,0,1,12,332,344
2012-03-07 08:00:00,0,1,12,554,566
2012-03-07 09:00:00,0,1,12,252,264
2012-03-07 10:00:00,0,1,20,127,147
2012-03-07 11:00:00,0,1,33,128,161
2012-03-07 12:00:00,0,1,40,175,215
2012-03-07 13:00:00,0,1,26,179,205
2012-03-07 14:00:00,0,1,38,137,175
2012-03-07 15:00:00,0,1,44,165,209
2012-03-07 16:00:00,0,1,34,254,288
2012-03-07 17:00:00,0,1,58,554,612
2012-03-07 18:00:00,0,1,35,509,544
2012-03-07 19:00:00,0,1,16,345,361
2012-03-07 20:00:00,0,1,18,242,260
2012-03-07 21:00:00,0,1,11,177,188
2012-03-07 22:00:00,0,1,10,149,159
2012-03-07 23:00:00,0,1,4,58,62
2012-03-08 00:00:00,0,1,11,35,46
2012-03-08 01:00:00,0,1,4,17,21
2012-03-08 02:00:00,0,1,6,5,11
2012-03-08 03:00:00,0,1,0,3,3
2012-03-08 04:00:00,0,1,0,2,2
2012-03-08 05:00:00,0,1,1,28,29
2012-03-08 06:00:00,0,1,4,105,109
2012-03-08 07:00:00,0,1,8,326,334
2012-03-08 08:00:00,0,1,12,573,585
2012-03-08 09:00:00,0,1,19,282,301
2012-03-08 10:00:00,0,1,19,119,138
2012-03-08 11:00:00,0,1,48,156,204
2012-03-08 12:00:00,0,1,27,224,251
2012-03-08 13:00:00,0,1,35,198,233
2012-03-08 14:00:00,0,1,48,155,203
2012-03-08 15:00:00,0,1,24,161,185
2012-03-08 16:00:00,0,1,37,305,342
2012-03-08 17:00:00,0,1,52,545,597
2012-03-08 18:00:00,0,1,45,545,590
2012-03-08 19:00:00,0,1,21,395,416
2012-03-08 20:00:00,0,1,20,282,302
2012-03-08 21:00:00,0,1,27,206,233
2012-03-08 22:00:00,0,1,12,141,153
2012-03-08 23:00:00,0,1,6,88,94
2012-03-09 00:00:00,0,1,3,51,54
2012-03-09 01:00:00,0,1,4,22,26
2012-03-09 02:00:00,0,1,2,9,11
2012-03-09 03:00:00,0,1,0,7,7
2012-03-09 04:00:00,0,1,0,1,1
2012-03-09 05:00:00,0,1,2,27,29
2012-03-09 06:00:00,0,1,2,83,85
2012-03-09 07:00:00,0,1,6,262,268
2012-03-09 08:00:00,0,1,17,484,501
2012-03-09 09:00:00,0,1,17,267,284
2012-03-09 10:00:00,0,1,14,145,159
2012-03-09 11:00:00,0,1,17,170,187
2012-03-09 12:00:00,0,1,27,174,201
2012-03-09 13:00:00,0,1,49,175,224
2012-03-09 14:00:00,0,1,49,129,178
2012-03-09 15:00:00,0,1,50,188,238
2012-03-09 16:00:00,0,1,51,292,343
2012-03-09 17:00:00,0,1,68,498,566
2012-03-09 18:00:00,0,1,30,440,470
2012-03-09 19:00:00,0,1,12,232,244
2012-03-09 20:00:00,0,1,3,156,159
2012-03-09 21:00:00,0,1,8,133,141
2012-03-09 22:00:00,0,1,7,100,107
2012-03-09 23:00:00,0,1,9,77,86
2012-03-10 00:00:00,0,0,9,68,77
2012-03-10 01:00:00,0,0,1,50,51
2012-03-10 02:00:00,0,0,12,30,42
2012-03-10 03:00:00,0,0,0,16,16
2012-03-10 04:00:00,0,0,1,3,4
2012-03-10 05:00:00,0,0,3,7,10
2012-03-10 06:00:00,0,0,1,11,12
2012-03-10 07:00:00,0,0,4,36,40
2012-03-10 08:00:00,0,0,15,96,111
2012-03-10 09:00:00,0,0,21,127,148
2012-03-10 10:00:00,0,0,47,176,223
2012-03-10 11:00:00,0,0,56,218,274
2012-03-10 12:00:00,0,0,88,241,329
2012-03-10 13:00:00,0,0,89,268,357
2012-03-10 14:00:00,0,0,117,262,379
2012-03-10 15:00:00,0,0,132,274,406
2012-03-10 16:00:00,0,0,115,275,390
2012-03-10 17:00:00,0,0,104,250,354
2012-03-10 18:00:00,0,0,67,230,297
2012-03-10 19:00:00,0,0,25,159,184
2012-03-10 20:00:00,0,0,20,101,121
2012-03-10 21:00:00,0,0,16,94,110
2012-03-10 22:00:00,0,0,19,81,100
2012-03-10 23:00:00,0,0,6,77,83
2012-03-11 00:00:00,0,0,7,62,69
2012-03-11 01:00:00,0,0,4,57,61
2012-03-11 03:00:00,0,0,15,51,66
2012-03-11 04:00:00,0,0,7,15,22
2012-03-11 05:00:00,0,0,2,5,7
2012-03-11 06:00:00,0,0,2,8,10
2012-03-11 07:00:00,0,0,2,15,17
2012-03-11 08:00:00,0,0,4,68,72
2012-03-11 09:00:00,0,0,20,70,90
2012-03-11 10:00:00,0,0,71,147,218
2012-03-11 11:00:00,0,0,90,209,299
2012-03-11 12:00:00,0,0,146,264,410
2012-03-11 13:00:00,0,0,176,288,464
2012-03-11 14:00:00,0,0,212,289,501
2012-03-11 15:00:00,0,0,201,286,487
2012-03-11 16:00:00,0,0,208,301,509
2012-03-11 17:00:00,0,0,199,299,498
2012-03-11 18:00:00,0,0,133,256,389
2012-03-11 19:00:00,0,0,55,203,258
2012-03-11 20:00:00,0,0,42,129,171
2012-03-11 21:00:00,0,0,37,110,147
2012-03-11 22:00:00,0,0,13,81,94
2012-03-11 23:00:00,0,0,12,40,52
2012-03-12 00:00:00,0,1,4,20,24
2012-03-12 01:00:00,0,1,1,9,10
2012-03-12 02:00:00,0,1,4,5,9
2012-03-12 03:00:00,0,1,0,2,2
2012-03-12 04:00:00,0,1,0,3,3
2012-03-12 05:00:00,0,1,1,15,16
2012-03-12 06:00:00,0,1,2,86,88
2012-03-12 07:00:00,0,1,9,259,268
2012-03-12 08:00:00,0,1,17,547,564
2012-03-12 09:00:00,0,1,21,260,281
2012-03-12 10:00:00,0,1,39,98,137
2012-03-12 11:00:00,0,1,39,111,150
2012-03-12 12:00:00,0,1,59,162,221
2012-03-12 13:00:00,0,1,74,176,250
2012-03-12 14:00:00,0,1,76,145,221
2012-03-12 15:00:00,0,1,74,159,233
2012-03-12 16:00:00,0,1,77,255,332
2012-03-12 17:00:00,0,1,87,557,644
2012-03-12 18:00:00,0,1,89,623,712
2012-03-12 19:00:00,0,1,67,379,446
2012-03-12 20:00:00,0,1,49,237,286
2012-03-12 21:00:00,0,1,22,183,205
2012-03-12 22:00:00,0,1,17,116,133
2012-03-12 23:00:00,0,1,10,53,63
2012-03-13 00:00:00,0,1,5,21,26
2012-03-13 01:00:00,0,1,2,14,16
2012-03-13 02:00:00,0,1,0,1,1
2012-03-13 03:00:00,0,1,0,2,2
2012-03-13 04:00:00,0,1,0,1,1
2012-03-13 05:00:00,0,1,0,24,24
2012-03-13 06:00:00,0,1,5,108,113
2012-03-13 07:00:00,0,1,16,292,308
2012-03-13 08:00:00,0,1,22,571,593
2012-03-13 09:00:00,0,1,18,324,342
2012-03-13 10:00:00,0,1,28,115,143
2012-03-13 11:00:00,0,1,64,155,219
2012-03-13 12:00:00,0,1,47,197,244
2012-03-13 13:00:00,0,1,53,180,233
2012-03-13 14:00:00,0,1,52,160,212
2012-03-13 15:00:00,0,1,68,196,264
2012-03-13 16:00:00,0,1,53,312,365
2012-03-13 17:00:00,0,1,62,614,676
2012-03-13 18:00:00,0,1,96,638,734
2012-03-13 19:00:00,0,1,50,429,479
2012-03-13 20:00:00,0,1,45,306,351
2012-03-13 21:00:00,0,1,44,200,244
2012-03-13 22:00:00,0,1,24,146,170
2012-03-13 23:00:00,0,1,8,79,87
2012-03-14 00:00:00,0,1,5,34,39
2012-03-14 01:00:00,0,1,2,25,27
2012-03-14 02:00:00,0,1,0,2,2
2012-03-14 03:00:00,0,1,1,3,4
2012-03-14 04:00:00,0,1,1,4,5
2012-03-14 05:00:00,0,1,2,25,27
2012-03-14 06:00:00,0,1,1,120,121
2012-03-14 07:00:00,0,1,20,348,368
2012-03-14 08:00:00,0,1,34,628,662
2012-03-14 09:00:00,0,1,26,325,351
2012-03-14 10:00:00,0,1,38,150,188
2012-03-14 11:00:00,0,1,65,155,220
2012-03-14 12:00:00,0,1,55,212,267
2012-03-14 13:00:00,0,1,57,197,254
2012-03-14 14:00:00,0,1,61,163,224
2012-03-14 15:00:00,0,1,86,197,283
2012-03-14 16:00:00,0,1,78,278,356
2012-03-14 17:00:00,0,1,140,642,782
2012-03-14 18:00:00,0,1,102,647,749
2012-03-14 19:00:00,0,1,70,402,472
2012-03-14 20:00:00,0,1,44,286,330
2012-03-14 21:00:00,0,1,47,241,288
2012-03-14 22:00:00,0,1,43,159,202
2012-03-14 23:00:00,0,1,19,72,91
2012-03-15 00:00:00,0,1,14,46,60
2012-03-15 01:00:00,0,1,15,8,23
2012-03-15 02:00:00,0,1,14,5,19
2012-03-15 03:00:00,0,1,0,7,7
2012-03-15 04:00:00,0,1,11,3,14
2012-03-15 05:00:00,0,1,2,24,26
2012-03-15 06:00:00,0,1,4,113,117
2012-03-15 07:00:00,0,1,14,367,381
2012-03-15 08:00:00,0,1,21,602,623
2012-03-15 09:00:00,0,1,30,285,315
2012-03-15 10:00:00,0,1,34,130,164
2012-03-15 11:00:00,0,1,60,151,211
2012-03-15 12:00:00,0,1,59,206,265
2012-03-15 13:00:00,0,1,62,211,273
2012-03-15 14:00:00,0,1,81,177,258
2012-03-15 15:00:00,0,1,100,187,287
2012-03-15 16:00:00,0,1,95,331,426
2012-03-15 17:00:00,0,1,79,634,713
2012-03-15 18:00:00,0,1,98,648,746
2012-03-15 19:00:00,0,1,72,353,425
2012-03-15 20:00:00,0,1,60,270,330
2012-03-15 21:00:00,0,1,36,207,243
2012-03-15 22:00:00,0,1,32,137,169
2012-03-15 23:00:00,0,1,12,85,97
2012-03-16 00:00:00,0,1,8,49,57
2012-03-16 01:00:00,0,1,4,22,26
2012-03-16 02:00:00,0,1,0,4,4
2012-03-16 03:00:00,0,1,0,3,3
2012-03-16 04:00:00,0,1,0,3,3
2012-03-16 05:00:00,0,1,2,30,32
2012-03-16 06:00:00,0,1,3,96,99
2012-03-16 07:00:00,0,1,13,265,278
2012-03-16 08:00:00,0,1,28,534,562
2012-03-16 09:00:00,0,1,35,277,312
2012-03-16 10:00:00,0,1,44,136,180
2012-03-16 11:00:00,0,1,40,167,207
2012-03-16 12:00:00,0,1,72,222,294
2012-03-16 13:00:00,0,1,52,208,260
2012-03-16 14:00:00,0,1,56,146,202
2012-03-16 15:00:00,0,1,19,88,107
2012-03-16 16:00:00,0,1,18,111,129
2012-03-16 17:00:00,0,1,23,235,258
2012-03-16 18:00:00,0,1,31,377,408
2012-03-16 19:00:00,0,1,23,273,296
2012-03-16 20:00:00,0,1,31,204,235
2012-03-16 21:00:00,0,1,8,144,152
2012-03-16 22:00:00,0,1,16,132,148
2012-03-16 23:00:00,0,1,22,104,126
2012-03-17 00:00:00,0,0,13,87,100
2012-03-17 01:00:00,0,0,12,57,69
2012-03-17 02:00:00,0,0,10,32,42
2012-03-17 03:00:00,0,0,2,24,26
2012-03-17 04:00:00,0,0,0,2,2
2012-03-17 05:00:00,0,0,5,3,8
2012-03-17 06:00:00,0,0,1,29,30
2012-03-17 07:00:00,0,0,29,57,86
2012-03-17 08:00:00,0,0,63,155,218
2012-03-17 09:00:00,0,0,104,217,321
2012-03-17 10:00:00,0,0,140,303,443
2012-03-17 11:00:00,0,0,226,359,585
2012-03-17 12:00:00,0,0,286,365,651
2012-03-17 13:00:00,0,0,286,400,686
2012-03-17 14:00:00,0,0,352,338,690
2012-03-17 15:00:00,0,0,357,322,679
2012-03-17 16:00:00,0,0,367,318,685
2012-03-17 17:00:00,0,0,291,357,648
2012-03-17 18:00:00,0,0,221,339,560
2012-03-17 19:00:00,0,0,155,262,417
2012-03-17 20:00:00,0,0,89,182,271
2012-03-17 21:00:00,0,0,54,169,223
2012-03-17 22:00:00,0,0,58,153,211
2012-03-17 23:00:00,0,0,34,151,185
2012-03-18 00:00:00,0,0,27,80,107
2012-03-18 01:00:00,0,0,25,88,113
2012-03-18 02:00:00,0,0,15,41,56
2012-03-18 03:00:00,0,0,3,15,18
2012-03-18 04:00:00,0,0,6,8,14
2012-03-18 05:00:00,0,0,0,6,6
2012-03-18 06:00:00,0,0,2,9,11
2012-03-18 07:00:00,0,0,17,25,42
2012-03-18 08:00:00,0,0,25,71,96
2012-03-18 09:00:00,0,0,65,113,178
2012-03-18 10:00:00,0,0,139,212,351
2012-03-18 11:00:00,0,0,129,239,368
2012-03-18 12:00:00,0,0,222,281,503
2012-03-18 13:00:00,0,0,198,346,544
2012-03-18 14:00:00,0,0,218,303,521
2012-03-18 15:00:00,0,0,240,314,554
2012-03-18 16:00:00,0,0,229,312,541
2012-03-18 17:00:00,0,0,233,308,541
2012-03-18 18:00:00,0,0,165,294,459
2012-03-18 19:00:00,0,0,118,234,352
2012-03-18 20:00:00,0,0,59,139,198
2012-03-18 21:00:00,0,0,44,129,173
2012-03-18 22:00:00,0,0,21,79,100
2012-03-18 23:00:00,0,0,7,39,46
2012-03-19 00:00:00,0,1,4,19,23
2012-03-19 01:00:00,0,1,0,15,15
2012-03-19 02:00:00,0,1,1,7,8
2012-03-19 03:00:00,0,1,0,2,2
2012-03-19 04:00:00,0,1,0,3,3
2012-03-19 05:00:00,0,1,0,31,31
2012-03-19 06:00:00,0,1,2,118,120
2012-03-19 07:00:00,0,1,25,329,354
2012-03-19 08:00:00,0,1,16,563,579
2012-03-19 09:00:00,0,1,55,276,331
2012-03-19 10:00:00,0,1,56,128,184
2012-03-19 11:00:00,0,1,56,145,201
2012-03-19 12:00:00,0,1,71,211,282
2012-03-19 13:00:00,0,1,69,194,263
2012-03-19 14:00:00,0,1,60,200,260
2012-03-19 15:00:00,0,1,97,189,286
2012-03-19 16:00:00,0,1,65,320,385
2012-03-19 17:00:00,0,1,106,615,721
2012-03-19 18:00:00,0,1,120,681,801
2012-03-19 19:00:00,0,1,86,463,549
2012-03-19 20:00:00,0,1,34,296,330
2012-03-19 21:00:00,0,1,33,190,223
2012-03-19 22:00:00,0,1,17,131,148
2012-03-19 23:00:00,0,1,9,45,54
2012-04-01 00:00:00,0,0,8,59,67
2012-04-01 01:00:00,0,0,13,49,62
2012-04-01 02:00:00,0,0,20,61,81
2012-04-01 03:00:00,0,0,4,21,25
2012-04-01 04:00:00,0,0,3,9,12
2012-04-01 05:00:00,0,0,8,10,18
2012-04-01 06:00:00,0,0,9,88,97
2012-04-01 07:00:00,0,0,29,55,84
2012-04-01 08:00:00,0,0,37,88,125
2012-04-01 09:00:00,0,0,102,173,275
2012-04-01 10:00:00,0,0,132,228,360
2012-04-01 11:00:00,0,0,180,271,451
2012-04-01 12:00:00,0,0,187,258,445
2012-04-01 13:00:00,0,0,190,274,464
2012-04-01 14:00:00,0,0,283,278,561
2012-04-01 15:00:00,0,0,295,278,573
2012-04-01 16:00:00,0,0,236,275,511
2012-04-01 17:00:00,0,0,232,323,555
2012-04-01 18:00:00,0,0,153,279,432
2012-04-01 19:00:00,0,0,110,236,346
2012-04-01 20:00:00,0,0,66,166,232
2012-04-01 21:00:00,0,0,33,101,134
2012-04-01 22:00:00,0,0,7,61,68
2012-04-01 23:00:00,0,0,10,53,63
2012-04-02 00:00:00,0,1,6,11,17
2012-04-02 01:00:00,0,1,0,5,5
2012-04-02 02:00:00,0,1,2,3,5
2012-04-02 04:00:00,0,1,2,2,4
2012-04-02 05:00:00,0,1,2,22,24
2012-04-02 06:00:00,0,1,6,104,110
2012-04-02 07:00:00,0,1,12,294,306
2012-04-02 08:00:00,0,1,36,553,589
2012-04-02 09:00:00,0,1,52,265,317
2012-04-02 10:00:00,0,1,85,119,204
2012-04-02 11:00:00,0,1,81,128,209
2012-04-02 12:00:00,0,1,100,181,281
2012-04-02 13:00:00,0,1,97,184,281
2012-04-02 14:00:00,0,1,127,141,268
2012-04-02 15:00:00,0,1,132,192,324
2012-04-02 16:00:00,0,1,104,291,395
2012-04-02 17:00:00,0,1,128,601,729
2012-04-02 18:00:00,0,1,75,543,618
2012-04-02 19:00:00,0,1,66,428,494
2012-04-02 20:00:00,0,1,48,281,329
2012-04-02 21:00:00,0,1,24,214,238
2012-04-02 22:00:00,0,1,17,106,123
2012-04-02 23:00:00,0,1,6,60,66
2012-04-03 00:00:00,0,1,1,32,33
2012-04-03 01:00:00,0,1,0,11,11
2012-04-03 02:00:00,0,1,0,5,5
2012-04-03 03:00:00,0,1,0,3,3
2012-04-03 04:00:00,0,1,0,1,1
2012-04-03 05:00:00,0,1,2,25,27
2012-04-03 06:00:00,0,1,2,98,100
2012-04-03 07:00:00,0,1,14,327,341
2012-04-03 08:00:00,0,1,27,577,604
2012-04-03 09:00:00,0,1,54,354,408
2012-04-03 10:00:00,0,1,77,142,219
2012-04-03 11:00:00,0,1,91,167,258
2012-04-03 12:00:00,0,1,101,230,331
2012-04-03 13:00:00,0,1,120,225,345
2012-04-03 14:00:00,0,1,120,191,311
2012-04-03 15:00:00,0,1,109,207,316
2012-04-03 16:00:00,0,1,145,340,485
2012-04-03 17:00:00,0,1,123,634,757
2012-04-03 18:00:00,0,1,139,661,800
2012-04-03 19:00:00,0,1,98,460,558
2012-04-03 20:00:00,0,1,54,325,379
2012-04-03 21:00:00,0,1,33,210,243
2012-04-03 22:00:00,0,1,25,133,158
2012-04-03 23:00:00,0,1,13,66,79
2012-04-04 00:00:00,0,1,18,23,41
2012-04-04 01:00:00,0,1,0,11,11
2012-04-04 02:00:00,0,1,0,5,5
2012-04-04 03:00:00,0,1,0,3,3
2012-04-04 04:00:00,0,1,0,1,1
2012-04-04 05:00:00,0,1,0,27,27
2012-04-04 06:00:00,0,1,6,120,126
2012-04-04 07:00:00,0,1,12,354,366
2012-04-04 08:00:00,0,1,31,653,684
2012-04-04 09:00:00,0,1,47,316,363
2012-04-04 10:00:00,0,1,68,99,167
2012-04-04 11:00:00,0,1,61,152,213
2012-04-04 12:00:00,0,1,73,210,283
2012-04-04 13:00:00,0,1,70,181,251
2012-04-04 14:00:00,0,1,82,176,258
2012-04-04 15:00:00,0,1,86,182,268
2012-04-04 16:00:00,0,1,86,304,390
2012-04-04 17:00:00,0,1,99,645,744
2012-04-04 18:00:00,0,1,113,646,759
2012-04-04 19:00:00,0,1,75,419,494
2012-04-04 20:00:00,0,1,39,333,372
2012-04-04 21:00:00,0,1,43,255,298
2012-04-04 22:00:00,0,1,30,151,181
2012-04-04 23:00:00,0,1,19,112,131
2012-04-05 00:00:00,0,1,12,33,45
2012-04-05 01:00:00,0,1,4,9,13
2012-04-05 02:00:00,0,1,7,11,18
2012-04-05 03:00:00,0,1,0,5,5
2012-04-05 04:00:00,0,1,0,1,1
2012-04-05 05:00:00,0,1,1,28,29
2012-04-05 06:00:00,0,1,8,118,126
2012-04-05 07:00:00,0,1,15,339,354
2012-04-05 08:00:00,0,1,28,610,638
2012-04-05 09:00:00,0,1,61,290,351
2012-04-05 10:00:00,0,1,88,158,246
2012-04-05 11:00:00,0,1,109,159,268
2012-04-05 12:00:00,0,1,66,210,276
2012-04-05 13:00:00,0,1,89,202,291
2012-04-05 14:00:00,0,1,143,144,287
2012-04-05 15:00:00,0,1,98,171,269
2012-04-05 16:00:00,0,1,84,318,402
2012-04-05 17:00:00,0,1,145,677,822
2012-04-05 18:00:00,0,1,80,618,698
2012-04-05 19:00:00,0,1,64,423,487
2012-04-05 20:00:00,0,1,33,279,312
2012-04-05 21:00:00,0,1,25,209,234
2012-04-05 22:00:00,0,1,20,129,149
2012-04-05 23:00:00,0,1,12,124,136
2012-04-06 00:00:00,0,1,12,49,61
2012-04-06 01:00:00,0,1,10,28,38
2012-04-06 02:00:00,0,1,6,5,11
2012-04-06 03:00:00,0,1,3,5,8
2012-04-06 04:00:00,0,1,2,3,5
2012-04-06 05:00:00,0,1,0,23,23
2012-04-06 06:00:00,0,1,0,80,80
2012-04-06 07:00:00,0,1,15,231,246
2012-04-06 08:00:00,0,1,19,489,508
2012-04-06 09:00:00,0,1,58,318,376
2012-04-06 10:00:00,0,1,81,157,238
2012-04-06 11:00:00,0,1,112,179,291
2012-04-06 12:00:00,0,1,113,224,337
2012-04-06 13:00:00,0,1,173,238,411
2012-04-06 14:00:00,0,1,240,250,490
2012-04-06 15:00:00,0,1,218,319,537
2012-04-06 16:00:00,0,1,184,352,536
2012-04-06 17:00:00,0,1,172,483,655
2012-04-06 18:00:00,0,1,104,380,484
2012-04-06 19:00:00,0,1,115,297,412
2012-04-06 20:00:00,0,1,61,191,252
2012-04-06 21:00:00,0,1,54,136,190
2012-04-06 22:00:00,0,1,34,124,158
2012-04-06 23:00:00,0,1,21,92,113
2012-04-07 00:00:00,0,0,9,85,94
2012-04-07 01:00:00,0,0,9,60,69
2012-04-07 02:00:00,0,0,11,25,36
2012-04-07 03:00:00,0,0,7,21,28
2012-04-07 04:00:00,0,0,3,4,7
2012-04-07 05:00:00,0,0,0,2,2
2012-04-07 06:00:00,0,0,1,18,19
2012-04-07 07:00:00,0,0,14,40,54
2012-04-07 08:00:00,0,0,29,94,123
2012-04-07 09:00:00,0,0,103,173,276
2012-04-07 10:00:00,0,0,187,176,363
2012-04-07 11:00:00,0,0,251,244,495
2012-04-07 12:00:00,0,0,320,270,590
2012-04-07 13:00:00,0,0,355,288,643
2012-04-07 14:00:00,0,0,326,252,578
2012-04-07 15:00:00,0,0,321,305,626
2012-04-07 16:00:00,0,0,354,261,615
2012-04-07 17:00:00,0,0,299,268,567
2012-04-07 18:00:00,0,0,227,290,517
2012-04-07 19:00:00,0,0,170,243,413
2012-04-07 20:00:00,0,0,73,135,208
2012-04-07 21:00:00,0,0,75,159,234
2012-04-07 22:00:00,0,0,76,106,182
2012-04-07 23:00:00,0,0,32,86,118
2012-04-08 00:00:00,0,0,21,64,85
2012-04-08 01:00:00,0,0,14,50,64
2012-04-08 02:00:00,0,0,7,25,32
2012-04-08 03:00:00,0,0,8,18,26
2012-04-08 04:00:00,0,0,0,7,7
2012-04-08 05:00:00,0,0,4,8,12
2012-04-08 06:00:00,0,0,7,21,28
2012-04-08 07:00:00,0,0,12,25,37
2012-04-08 08:00:00,0,0,19,65,84
2012-04-08 09:00:00,0,0,71,108,179
2012-04-08 10:00:00,0,0,113,186,299
2012-04-08 11:00:00,0,0,195,209,404
2012-04-08 12:00:00,0,0,198,259,457
2012-04-08 13:00:00,0,0,229,254,483
2012-04-08 14:00:00,0,0,254,249,503
2012-04-08 15:00:00,0,0,260,226,486
2012-04-08 16:00:00,0,0,232,244,476
2012-04-08 17:00:00,0,0,185,226,411
2012-04-08 18:00:00,0,0,151,159,310
2012-04-08 19:00:00,0,0,89,187,276
2012-04-08 20:00:00,0,0,65,146,211
2012-04-08 21:00:00,0,0,53,77,130
2012-04-08 22:00:00,0,0,33,85,118
2012-04-08 23:00:00,0,0,10,41,51
2012-04-09 00:00:00,0,1,8,29,37
2012-04-09 01:00:00,0,1,4,12,16
2012-04-09 02:00:00,0,1,2,4,6
2012-04-09 03:00:00,0,1,0,3,3
2012-04-09 04:00:00,0,1,2,3,5
2012-04-09 05:00:00,0,1,2,30,32
2012-04-09 06:00:00,0,1,3,108,111
2012-04-09 07:00:00,0,1,11,320,331
2012-04-09 08:00:00,0,1,22,595,617
2012-04-09 09:00:00,0,1,50,236,286
2012-04-09 10:00:00,0,1,65,113,178
2012-04-09 11:00:00,0,1,96,127,223
2012-04-09 12:00:00,0,1,94,186,280
2012-04-09 13:00:00,0,1,108,173,281
2012-04-09 14:00:00,0,1,66,152,218
2012-04-09 15:00:00,0,1,82,173,255
2012-04-09 16:00:00,0,1,81,310,391
2012-04-09 17:00:00,0,1,67,565,632
2012-04-09 18:00:00,0,1,60,586,646
2012-04-09 19:00:00,0,1,35,386,421
2012-04-09 20:00:00,0,1,21,255,276
2012-04-09 21:00:00,0,1,14,151,165
2012-04-09 22:00:00,0,1,6,102,108
2012-04-09 23:00:00,0,1,6,61,67
2012-04-10 00:00:00,0,1,3,23,26
2012-04-10 01:00:00,0,1,0,9,9
2012-04-10 02:00:00,0,1,0,2,2
2012-04-10 03:00:00,0,1,0,2,2
2012-04-10 04:00:00,0,1,0,2,2
2012-04-10 05:00:00,0,1,0,24,24
2012-04-10 06:00:00,0,1,3,100,103
2012-04-10 07:00:00,0,1,16,368,384
2012-04-10 08:00:00,0,1,22,670,692
2012-04-10 09:00:00,0,1,16,303,319
2012-04-10 10:00:00,0,1,49,132,181
2012-04-10 11:00:00,0,1,78,161,239
2012-04-10 12:00:00,0,1,75,184,259
2012-04-10 13:00:00,0,1,81,202,283
2012-04-10 14:00:00,0,1,75,149,224
2012-04-10 15:00:00,0,1,46,157,203
2012-04-10 16:00:00,0,1,66,296,362
2012-04-10 17:00:00,0,1,88,656,744
2012-04-10 18:00:00,0,1,78,626,704
2012-04-10 19:00:00,0,1,51,428,479
2012-04-10 20:00:00,0,1,34,248,282
2012-04-10 21:00:00,0,1,15,191,206
2012-04-10 22:00:00,0,1,9,118,127
2012-04-10 23:00:00,0,1,14,48,62
2012-04-11 00:00:00,0,1,8,22,30
2012-04-11 01:00:00,0,1,3,9,12
2012-04-11 02:00:00,0,1,0,2,2
2012-04-11 03:00:00,0,1,0,2,2
2012-04-11 05:00:00,0,1,1,26,27
2012-04-11 06:00:00,0,1,3,103,106
2012-04-11 07:00:00,0,1,18,303,321
2012-04-11 08:00:00,0,1,14,581,595
2012-04-11 09:00:00,0,1,20,282,302
2012-04-11 10:00:00,0,1,26,127,153
2012-04-11 11:00:00,0,1,38,142,180
2012-04-11 12:00:00,0,1,35,147,182
2012-04-11 13:00:00,0,1,16,147,163
2012-04-11 14:00:00,0,1,34,101,135
2012-04-11 15:00:00,0,1,50,152,202
2012-04-11 16:00:00,0,1,51,256,307
2012-04-11 17:00:00,0,1,52,527,579
2012-04-11 18:00:00,0,1,39,546,585
2012-04-11 19:00:00,0,1,28,356,384
2012-04-11 20:00:00,0,1,22,213,235
2012-04-11 21:00:00,0,1,11,154,165
2012-04-11 22:00:00,0,1,4,130,134
2012-04-11 23:00:00,0,1,9,52,61
2012-04-12 00:00:00,0,1,1,22,23
2012-04-12 01:00:00,0,1,2,7,9
2012-04-12 02:00:00,0,1,0,4,4
2012-04-12 03:00:00,0,1,2,3,5
2012-04-12 04:00:00,0,1,0,1,1
2012-04-12 05:00:00,0,1,0,21,21
2012-04-12 06:00:00,0,1,2,94,96
2012-04-12 07:00:00,0,1,12,294,306
2012-04-12 08:00:00,0,1,20,604,624
2012-04-12 09:00:00,0,1,16,271,287
2012-04-12 10:00:00,0,1,38,103,141
2012-04-12 11:00:00,0,1,50,174,224
2012-04-12 12:00:00,0,1,60,199,259
2012-04-12 13:00:00,0,1,55,148,203
2012-04-12 14:00:00,0,1,74,150,224
2012-04-12 15:00:00,0,1,42,169,211
2012-04-12 16:00:00,0,1,54,299,353
2012-04-12 17:00:00,0,1,60,596,656
2012-04-12 18:00:00,0,1,63,547,610
2012-04-12 19:00:00,0,1,50,383,433
2012-04-12 20:00:00,0,1,26,254,280
2012-04-12 21:00:00,0,1,13,174,187
2012-04-12 22:00:00,0,1,15,143,158
2012-04-12 23:00:00,0,1,8,86,94
2012-04-13 00:00:00,0,1,14,41,55
2012-04-13 01:00:00,0,1,2,28,30
2012-04-13 02:00:00,0,1,6,5,11
2012-04-13 03:00:00,0,1,3,8,11
2012-04-13 04:00:00,0,1,1,4,5
2012-04-13 05:00:00,0,1,2,19,21
2012-04-13 06:00:00,0,1,0,84,84
2012-04-13 07:00:00,0,1,13,283,296
2012-04-13 08:00:00,0,1,24,539,563
2012-04-13 09:00:00,0,1,36,294,330
2012-04-13 10:00:00,0,1,59,133,192
2012-04-13 11:00:00,0,1,75,158,233
2012-04-13 12:00:00,0,1,104,218,322
2012-04-13 13:00:00,0,1,112,246,358
2012-04-13 14:00:00,0,1,125,223,348
2012-04-13 15:00:00,0,1,115,237,352
2012-04-13 16:00:00,0,1,113,350,463
2012-04-13 17:00:00,0,1,117,621,738
2012-04-13 18:00:00,0,1,107,564,671
2012-04-13 19:00:00,0,1,75,352,427
2012-04-13 20:00:00,0,1,44,242,286
2012-04-13 21:00:00,0,1,36,153,189
2012-04-13 22:00:00,0,1,34,181,215
2012-04-13 23:00:00,0,1,35,163,198
2012-04-14 00:00:00,0,0,11,85,96
2012-04-14 01:00:00,0,0,10,60,70
2012-04-14 02:00:00,0,0,3,53,56
2012-04-14 03:00:00,0,0,6,26,32
2012-04-14 04:00:00,0,0,5,9,14
2012-04-14 05:00:00,0,0,2,5,7
2012-04-14 06:00:00,0,0,2,19,21
2012-04-14 07:00:00,0,0,8,56,64
2012-04-14 08:00:00,0,0,24,136,160
2012-04-14 09:00:00,0,0,59,206,265
2012-04-14 10:00:00,0,0,139,267,406
2012-04-14 11:00:00,0,0,207,357,564
2012-04-14 12:00:00,0,0,274,404,678
2012-04-14 13:00:00,0,0,308,370,678
2012-04-14 14:00:00,0,0,288,372,660
2012-04-14 15:00:00,0,0,311,347,658
2012-04-14 16:00:00,0,0,253,329,582
2012-04-14 17:00:00,0,0,251,309,560
2012-04-14 18:00:00,0,0,197,284,481
2012-04-14 19:00:00,0,0,163,296,459
2012-04-14 20:00:00,0,0,112,209,321
2012-04-14 21:00:00,0,0,53,167,220
2012-04-14 22:00:00,0,0,64,148,212
2012-04-14 23:00:00,0,0,45,151,196
2012-04-15 00:00:00,0,0,30,94,124
2012-04-15 01:00:00,0,0,17,89,106
2012-04-15 02:00:00,0,0,20,54,74
2012-04-15 03:00:00,0,0,18,27,45
2012-04-15 04:00:00,0,0,2,10,12
2012-04-15 05:00:00,0,0,4,6,10
2012-04-15 06:00:00,0,0,5,11,16
2012-04-15 07:00:00,0,0,16,30,46
2012-04-15 08:00:00,0,0,33,64,97
2012-04-15 09:00:00,0,0,97,154,251
2012-04-15 10:00:00,0,0,186,235,421
2012-04-15 11:00:00,0,0,227,301,528
2012-04-15 12:00:00,0,0,275,360,635
2012-04-15 13:00:00,0,0,298,383,681
2012-04-15 14:00:00,0,0,282,346,628
2012-04-15 15:00:00,0,0,266,351,617
2012-04-15 16:00:00,0,0,286,330,616
2012-04-15 17:00:00,0,0,262,361,623
2012-04-15 18:00:00,0,0,184,295,479
2012-04-15 19:00:00,0,0,114,265,379
2012-04-15 20:00:00,0,0,86,205,291
2012-04-15 21:00:00,0,0,76,153,229
2012-04-15 22:00:00,0,0,37,97,134
2012-04-15 23:00:00,0,0,25,65,90
2012-04-16 00:00:00,1,0,15,26,41
2012-04-16 01:00:00,1,0,7,21,28
2012-04-16 02:00:00,1,0,5,9,14
2012-04-16 03:00:00,1,0,3,5,8
2012-04-16 04:00:00,1,0,0,6,6
2012-04-16 05:00:00,1,0,4,34,38
2012-04-16 06:00:00,1,0,10,123,133
2012-04-16 07:00:00,1,0,20,367,387
2012-04-16 08:00:00,1,0,48,549,597
2012-04-16 09:00:00,1,0,59,238,297
2012-04-16 10:00:00,1,0,75,149,224
2012-04-16 11:00:00,1,0,115,136,251
2012-04-16 12:00:00,1,0,75,196,271
2012-04-16 13:00:00,1,0,79,184,263
2012-04-16 14:00:00,1,0,105,183,288
2012-04-16 15:00:00,1,0,81,194,275
2012-04-16 16:00:00,1,0,92,266,358
2012-04-16 17:00:00,1,0,111,601,712
2012-04-16 18:00:00,1,0,87,589,676
2012-04-16 19:00:00,1,0,61,461,522
2012-04-16 20:00:00,1,0,48,327,375
2012-04-16 21:00:00,1,0,39,232,271
2012-04-16 22:00:00,1,0,35,179,214
2012-04-16 23:00:00,1,0,24,97,121
2012-04-17 00:00:00,0,1,10,33,43
2012-04-17 01:00:00,0,1,6,5,11
2012-04-17 02:00:00,0,1,1,3,4
2012-04-17 03:00:00,0,1,0,6,6
2012-04-17 04:00:00,0,1,3,6,9
2012-04-17 05:00:00,0,1,1,29,30
2012-04-17 06:00:00,0,1,8,136,144
2012-04-17 07:00:00,0,1,18,443,461
2012-04-17 08:00:00,0,1,42,631,673
2012-04-17 09:00:00,0,1,71,329,400
2012-04-17 10:00:00,0,1,52,165,217
2012-04-17 11:00:00,0,1,65,174,239
2012-04-17 12:00:00,0,1,65,179,244
2012-04-17 13:00:00,0,1,52,187,239
2012-04-17 14:00:00,0,1,59,198,257
2012-04-17 15:00:00,0,1,91,217,308
2012-04-17 16:00:00,0,1,50,320,370
2012-04-17 17:00:00,0,1,108,673,781
2012-04-17 18:00:00,0,1,105,670,775
2012-04-17 19:00:00,0,1,73,464,537
2012-04-17 20:00:00,0,1,44,358,402
2012-04-17 21:00:00,0,1,37,260,297
2012-04-17 22:00:00,0,1,18,144,162
2012-04-17 23:00:00,0,1,10,72,82
2012-04-18 00:00:00,0,1,3,35,38
2012-04-18 01:00:00,0,1,1,13,14
2012-04-18 02:00:00,0,1,1,8,9
2012-04-18 03:00:00,0,1,0,6,6
2012-04-18 04:00:00,0,1,0,7,7
2012-04-18 05:00:00,0,1,0,34,34
2012-04-18 06:00:00,0,1,6,128,134
2012-04-18 07:00:00,0,1,10,408,418
2012-04-18 08:00:00,0,1,25,551,576
2012-04-18 09:00:00,0,1,20,245,265
2012-04-18 10:00:00,0,1,31,116,147
2012-04-18 11:00:00,0,1,14,105,119
2012-04-18 12:00:00,0,1,15,95,110
2012-04-18 13:00:00,0,1,13,51,64
2012-04-18 14:00:00,0,1,8,43,51
2012-04-18 15:00:00,0,1,10,88,98
2012-04-18 16:00:00,0,1,36,199,235
2012-04-18 17:00:00,0,1,46,442,488
2012-04-18 18:00:00,0,1,27,478,505
2012-04-18 19:00:00,0,1,26,342,368
2012-04-18 20:00:00,0,1,8,252,260
2012-04-18 21:00:00,0,1,24,165,189
2012-04-18 22:00:00,0,1,9,153,162
2012-04-18 23:00:00,0,1,14,56,70
2012-04-19 00:00:00,0,1,5,20,25
2012-04-19 01:00:00,0,1,2,11,13
2012-04-19 02:00:00,0,1,2,4,6
2012-04-19 03:00:00,0,1,1,3,4
2012-04-19 04:00:00,0,1,0,4,4
2012-04-19 05:00:00,0,1,0,30,30
2012-04-19 06:00:00,0,1,4,116,120
2012-04-19 07:00:00,0,1,15,391,406
2012-04-19 08:00:00,0,1,26,651,677
2012-04-19 09:00:00,0,1,31,270,301
2012-04-19 10:00:00,0,1,46,143,189
2012-04-19 11:00:00,0,1,46,183,229
2012-04-19 12:00:00,0,1,51,213,264
2012-04-19 13:00:00,0,1,52,186,238
2012-04-19 14:00:00,0,1,54,183,237
2012-04-19 15:00:00,0,1,66,196,262
2012-04-19 16:00:00,0,1,63,324,387
2012-04-19 17:00:00,0,1,85,663,748
2012-04-19 18:00:00,0,1,99,677,776
2012-04-19 19:00:00,0,1,70,516,586
2012-04-19 20:00:00,0,1,52,352,404
2012-04-19 21:00:00,0,1,27,240,267
2012-04-19 22:00:00,0,1,29,219,248
2012-04-19 23:00:00,0,1,20,124,144
2012-05-01 00:00:00,0,1,7,28,35
2012-05-01 01:00:00,0,1,0,21,21
2012-05-01 02:00:00,0,1,1,7,8
2012-05-01 03:00:00,0,1,1,2,3
2012-05-01 04:00:00,0,1,1,7,8
2012-05-01 05:00:00,0,1,0,17,17
2012-05-01 06:00:00,0,1,2,24,26
2012-05-01 07:00:00,0,1,8,161,169
2012-05-01 08:00:00,0,1,19,538,557
2012-05-01 09:00:00,0,1,18,331,349
2012-05-01 10:00:00,0,1,30,144,174
2012-05-01 11:00:00,0,1,50,179,229
2012-05-01 12:00:00,0,1,41,228,269
2012-05-01 13:00:00,0,1,41,208,249
2012-05-01 14:00:00,0,1,37,167,204
2012-05-01 15:00:00,0,1,48,186,234
2012-05-01 16:00:00,0,1,41,313,354
2012-05-01 17:00:00,0,1,65,616,681
2012-05-01 18:00:00,0,1,81,662,743
2012-05-01 19:00:00,0,1,58,429,487
2012-05-01 20:00:00,0,1,36,299,335
2012-05-01 21:00:00,0,1,31,251,282
2012-05-01 22:00:00,0,1,21,190,211
2012-05-01 23:00:00,0,1,16,79,95
2012-05-02 00:00:00,0,1,4,43,47
2012-05-02 01:00:00,0,1,8,7,15
2012-05-02 02:00:00,0,1,7,9,16
2012-05-02 03:00:00,0,1,0,6,6
2012-05-02 04:00:00,0,1,2,2,4
2012-05-02 05:00:00,0,1,2,31,33
2012-05-02 06:00:00,0,1,3,117,120
2012-05-02 07:00:00,0,1,14,344,358
2012-05-02 08:00:00,0,1,26,640,666
2012-05-02 09:00:00,0,1,26,289,315
2012-05-02 10:00:00,0,1,28,147,175
2012-05-02 11:00:00,0,1,39,145,184
2012-05-02 12:00:00,0,1,35,210,245
2012-05-02 13:00:00,0,1,49,179,228
2012-05-02 14:00:00,0,1,51,189,240
2012-05-02 15:00:00,0,1,52,204,256
2012-05-02 16:00:00,0,1,54,313,367
2012-05-02 17:00:00,0,1,70,659,729
2012-05-02 18:00:00,0,1,43,770,813
2012-05-02 19:00:00,0,1,43,461,504
2012-05-02 20:00:00,0,1,42,296,338
2012-05-02 21:00:00,0,1,21,218,239
2012-05-02 22:00:00,0,1,27,146,173
2012-05-02 23:00:00,0,1,21,77,98
2012-05-03 00:00:00,0,1,15,75,90
2012-05-03 01:00:00,0,1,9,15,24
2012-05-03 02:00:00,0,1,4,13,17
2012-05-03 03:00:00,0,1,2,4,6
2012-05-03 04:00:00,0,1,0,2,2
2012-05-03 05:00:00,0,1,1,20,21
2012-05-03 06:00:00,0,1,8,128,136
2012-05-03 07:00:00,0,1,8,376,384
2012-05-03 08:00:00,0,1,19,608,627
2012-05-03 09:00:00,0,1,25,279,304
2012-05-03 10:00:00,0,1,36,132,168
2012-05-03 11:00:00,0,1,34,167,201
2012-05-03 12:00:00,0,1,64,237,301
2012-05-03 13:00:00,0,1,48,217,265
2012-05-03 14:00:00,0,1,33,171,204
2012-05-03 15:00:00,0,1,63,220,283
2012-05-03 16:00:00,0,1,45,325,370
2012-05-03 17:00:00,0,1,87,617,704
2012-05-03 18:00:00,0,1,64,642,706
2012-05-03 19:00:00,0,1,55,467,522
2012-05-03 20:00:00,0,1,52,368,420
2012-05-03 21:00:00,0,1,42,257,299
2012-05-03 22:00:00,0,1,29,217,246
2012-05-03 23:00:00,0,1,21,100,121
2012-05-04 00:00:00,0,1,19,70,89
2012-05-04 01:00:00,0,1,15,33,48
2012-05-04 02:00:00,0,1,0,11,11
2012-05-04 03:00:00,0,1,0,14,14
2012-05-04 04:00:00,0,1,0,4,4
2012-05-04 05:00:00,0,1,0,24,24
2012-05-04 06:00:00,0,1,8,127,135
2012-05-04 07:00:00,0,1,9,347,356
2012-05-04 08:00:00,0,1,34,584,618
2012-05-04 09:00:00,0,1,32,262,294
2012-05-04 10:00:00,0,1,45,154,199
2012-05-04 11:00:00,0,1,77,181,258
2012-05-04 12:00:00,0,1,46,125,171
2012-05-04 13:00:00,0,1,71,207,278
2012-05-04 14:00:00,0,1,83,159,242
2012-05-04 15:00:00,0,1,103,240,343
2012-05-04 16:00:00,0,1,82,358,440
2012-05-04 17:00:00,0,1,96,547,643
2012-05-04 18:00:00,0,1,77,564,641
2012-05-04 19:00:00,0,1,64,388,452
2012-05-04 20:00:00,0,1,58,255,313
2012-05-04 21:00:00,0,1,49,186,235
2012-05-04 22:00:00,0,1,50,182,232
2012-05-04 23:00:00,0,1,51,205,256
2012-05-05 00:00:00,0,0,42,111,153
2012-05-05 01:00:00,0,0,28,79,107
2012-05-05 02:00:00,0,0,24,51,75
2012-05-05 03:00:00,0,0,11,21,32
2012-05-05 04:00:00,0,0,0,9,9
2012-05-05 05:00:00,0,0,8,14,22
2012-05-05 06:00:00,0,0,9,33,42
2012-05-05 07:00:00,0,0,8,79,87
2012-05-05 08:00:00,0,0,42,155,197
2012-05-05 09:00:00,0,0,61,223,284
2012-05-05 10:00:00,0,0,148,284,432
2012-05-05 11:00:00,0,0,221,354,575
2012-05-05 12:00:00,0,0,220,330,550
2012-05-05 13:00:00,0,0,217,307,524
2012-05-05 14:00:00,0,0,187,241,428
2012-05-05 15:00:00,0,0,241,300,541
2012-05-05 16:00:00,0,0,230,310,540
2012-05-05 17:00:00,0,0,204,298,502
2012-05-05 18:00:00,0,0,156,278,434
2012-05-05 19:00:00,0,0,151,254,405
2012-05-05 20:00:00,0,0,100,209,309
2012-05-05 21:00:00,0,0,86,183,269
2012-05-05 22:00:00,0,0,67,150,217
2012-05-05 23:00:00,0,0,35,114,149
2012-05-06 00:00:00,0,0,23,111,134
2012-05-06 01:00:00,0,0,37,84,121
2012-05-06 02:00:00,0,0,29,64,93
2012-05-06 03:00:00,0,0,9,19,28
2012-05-06 04:00:00,0,0,9,7,16
2012-05-06 05:00:00,0,0,1,10,11
2012-05-06 06:00:00,0,0,3,14,17
2012-05-06 07:00:00,0,0,5,31,36
2012-05-06 08:00:00,0,0,23,91,114
2012-05-06 09:00:00,0,0,63,128,191
2012-05-06 10:00:00,0,0,112,221,333
2012-05-06 11:00:00,0,0,144,270,414
2012-05-06 12:00:00,0,0,207,351,558
2012-05-06 13:00:00,0,0,197,368,565
2012-05-06 14:00:00,0,0,226,292,518
2012-05-06 15:00:00,0,0,229,342,571
2012-05-06 16:00:00,0,0,181,363,544
2012-05-06 17:00:00,0,0,195,316,511
2012-05-06 18:00:00,0,0,131,332,463
2012-05-06 19:00:00,0,0,117,266,383
2012-05-06 20:00:00,0,0,73,203,276
2012-05-06 21:00:00,0,0,55,148,203
2012-05-06 22:00:00,0,0,44,113,157
2012-05-06 23:00:00,0,0,22,80,102
2012-05-07 00:00:00,0,1,13,21,34
2012-05-07 01:00:00,0,1,1,8,9
2012-05-07 02:00:00,0,1,1,5,6
2012-05-07 03:00:00,0,1,2,3,5
2012-05-07 04:00:00,0,1,0,2,2
2012-05-07 05:00:00,0,1,2,21,23
2012-05-07 06:00:00,0,1,8,134,142
2012-05-07 07:00:00,0,1,18,367,385
2012-05-07 08:00:00,0,1,31,608,639
2012-05-07 09:00:00,0,1,61,289,350
2012-05-07 10:00:00,0,1,62,128,190
2012-05-07 11:00:00,0,1,64,149,213
2012-05-07 12:00:00,0,1,74,189,263
2012-05-07 13:00:00,0,1,75,197,272
2012-05-07 14:00:00,0,1,59,180,239
2012-05-07 15:00:00,0,1,76,186,262
2012-05-07 16:00:00,0,1,68,320,388
2012-05-07 17:00:00,0,1,102,667,769
2012-05-07 18:00:00,0,1,78,602,680
2012-05-07 19:00:00,0,1,83,463,546
2012-05-07 20:00:00,0,1,46,277,323
2012-05-07 21:00:00,0,1,37,210,247
2012-05-07 22:00:00,0,1,26,147,173
2012-05-07 23:00:00,0,1,21,92,113
2012-05-08 00:00:00,0,1,10,28,38
2012-05-08 01:00:00,0,1,6,3,9
2012-05-08 02:00:00,0,1,9,7,16
2012-05-08 03:00:00,0,1,2,4,6
2012-05-08 04:00:00,0,1,0,5,5
2012-05-08 05:00:00,0,1,0,20,20
2012-05-08 06:00:00,0,1,7,158,165
2012-05-08 07:00:00,0,1,21,442,463
2012-05-08 08:00:00,0,1,36,605,641
2012-05-08 09:00:00,0,1,37,258,295
2012-05-08 10:00:00,0,1,46,111,157
2012-05-08 11:00:00,0,1,60,157,217
2012-05-08 12:00:00,0,1,60,203,263
2012-05-08 13:00:00,0,1,53,166,219
2012-05-08 14:00:00,0,1,8,63,71
2012-05-08 15:00:00,0,1,40,94,134
2012-05-08 16:00:00,0,1,54,335,389
2012-05-08 17:00:00,0,1,77,640,717
2012-05-08 18:00:00,0,1,69,641,710
2012-05-08 19:00:00,0,1,59,399,458
2012-05-08 20:00:00,0,1,40,262,302
2012-05-08 21:00:00,0,1,21,202,223
2012-05-08 22:00:00,0,1,13,134,147
2012-05-08 23:00:00,0,1,10,53,63
2012-05-09 00:00:00,0,1,8,27,35
2012-05-09 01:00:00,0,1,3,11,14
2012-05-09 02:00:00,0,1,0,1,1
2012-05-09 03:00:00,0,1,0,2,2
2012-05-09 04:00:00,0,1,0,5,5
2012-05-09 05:00:00,0,1,1,27,28
2012-05-09 06:00:00,0,1,5,121,126
2012-05-09 07:00:00,0,1,17,401,418
2012-05-09 08:00:00,0,1,28,594,622
2012-05-09 09:00:00,0,1,40,285,325
2012-05-09 10:00:00,0,1,40,113,153
2012-05-09 11:00:00,0,1,45,156,201
2012-05-09 12:00:00,0,1,58,222,280
2012-05-09 13:00:00,0,1,50,216,266
2012-05-09 14:00:00,0,1,68,175,243
2012-05-09 15:00:00,0,1,68,191,259
2012-05-09 16:00:00,0,1,68,289,357
2012-05-09 17:00:00,0,1,76,629,705
2012-05-09 18:00:00,0,1,23,349,372
2012-05-09 19:00:00,0,1,2,96,98
2012-05-09 20:00:00,0,1,3,48,51
2012-05-09 21:00:00,0,1,4,30,34
2012-05-09 22:00:00,0,1,5,62,67
2012-05-09 23:00:00,0,1,8,47,55
2012-05-10 00:00:00,0,1,2,31,33
2012-05-10 01:00:00,0,1,2,9,11
2012-05-10 02:00:00,0,1,0,3,3
2012-05-10 03:00:00,0,1,0,3,3
2012-05-10 04:00:00,0,1,0,2,2
2012-05-10 05:00:00,0,1,1,23,24
2012-05-10 06:00:00,0,1,9,130,139
2012-05-10 07:00:00,0,1,8,393,401
2012-05-10 08:00:00,0,1,27,603,630
2012-05-10 09:00:00,0,1,62,299,361
2012-05-10 10:00:00,0,1,42,112,154
2012-05-10 11:00:00,0,1,77,179,256
2012-05-10 12:00:00,0,1,65,207,272
2012-05-10 13:00:00,0,1,90,228,318
2012-05-10 14:00:00,0,1,61,186,247
2012-05-10 15:00:00,0,1,79,192,271
2012-05-10 16:00:00,0,1,87,334,421
2012-05-10 17:00:00,0,1,84,648,732
2012-05-10 18:00:00,0,1,109,661,770
2012-05-10 19:00:00,0,1,84,469,553
2012-05-10 20:00:00,0,1,59,315,374
2012-05-10 21:00:00,0,1,19,211,230
2012-05-10 22:00:00,0,1,36,196,232
2012-05-10 23:00:00,0,1,23,112,135
2012-05-11 00:00:00,0,1,17,47,64
2012-05-11 01:00:00,0,1,14,32,46
2012-05-11 02:00:00,0,1,15,16,31
2012-05-11 03:00:00,0,1,5,8,13
2012-05-11 04:00:00,0,1,3,6,9
2012-05-11 05:00:00,0,1,3,23,26
2012-05-11 06:00:00,0,1,7,128,135
2012-05-11 07:00:00,0,1,6,345,351
2012-05-11 08:00:00,0,1,41,579,620
2012-05-11 09:00:00,0,1,34,288,322
2012-05-11 10:00:00,0,1,69,141,210
2012-05-11 11:00:00,0,1,88,203,291
2012-05-11 12:00:00,0,1,89,259,348
2012-05-11 13:00:00,0,1,100,263,363
2012-05-11 14:00:00,0,1,116,218,334
2012-05-11 15:00:00,0,1,140,299,439
2012-05-11 16:00:00,0,1,128,397,525
2012-05-11 17:00:00,0,1,102,677,779
2012-05-11 18:00:00,0,1,78,518,596
2012-05-11 19:00:00,0,1,73,430,503
2012-05-11 20:00:00,0,1,64,277,341
2012-05-11 21:00:00,0,1,45,225,270
2012-05-11 22:00:00,0,1,44,190,234
2012-05-11 23:00:00,0,1,38,142,180
2012-05-12 00:00:00,0,0,25,111,136
2012-05-12 01:00:00,0,0,14,79,93
2012-05-12 02:00:00,0,0,10,46,56
2012-05-12 03:00:00,0,0,14,20,34
2012-05-12 04:00:00,0,0,3,6,9
2012-05-12 05:00:00,0,0,5,8,13
2012-05-12 06:00:00,0,0,10,23,33
2012-05-12 07:00:00,0,0,10,57,67
2012-05-12 08:00:00,0,0,22,156,178
2012-05-12 09:00:00,0,0,87,248,335
2012-05-12 10:00:00,0,0,132,279,411
2012-05-12 11:00:00,0,0,157,365,522
2012-05-12 12:00:00,0,0,206,353,559
2012-05-12 13:00:00,0,0,293,366,659
2012-05-12 14:00:00,0,0,257,358,615
2012-05-12 15:00:00,0,0,269,321,590
2012-05-12 16:00:00,0,0,254,337,591
2012-05-12 17:00:00,0,0,233,343,576
2012-05-12 18:00:00,0,0,164,382,546
2012-05-12 19:00:00,0,0,166,273,439
2012-05-12 20:00:00,0,0,113,174,287
2012-05-12 21:00:00,0,0,74,156,230
2012-05-12 22:00:00,0,0,62,212,274
2012-05-12 23:00:00,0,0,42,134,176
2012-05-13 00:00:00,0,0,19,79,98
2012-05-13 01:00:00,0,0,22,72,94
2012-05-13 02:00:00,0,0,22,60,82
2012-05-13 03:00:00,0,0,2,26,28
2012-05-13 04:00:00,0,0,2,7,9
2012-05-13 05:00:00,0,0,4,8,12
2012-05-13 06:00:00,0,0,6,15,21
2012-05-13 07:00:00,0,0,18,42,60
2012-05-13 08:00:00,0,0,32,124,156
2012-05-13 09:00:00,0,0,79,143,222
2012-05-13 10:00:00,0,0,128,222,350
2012-05-13 11:00:00,0,0,150,278,428
2012-05-13 12:00:00,0,0,189,342,531
2012-05-13 13:00:00,0,0,255,347,602
2012-05-13 14:00:00,0,0,228,324,552
2012-05-13 15:00:00,0,0,190,309,499
2012-05-13 16:00:00,0,0,225,339,564
2012-05-13 17:00:00,0,0,191,287,478
2012-05-13 18:00:00,0,0,129,260,389
2012-05-13 19:00:00,0,0,107,232,339
2012-05-13 20:00:00,0,0,67,163,230
2012-05-13 21:00:00,0,0,48,121,169
2012-05-13 22:00:00,0,0,42,89,131
2012-05-13 23:00:00,0,0,17,57,74
2012-05-14 00:00:00,0,1,21,14,35
2012-05-14 01:00:00,0,1,5,6,11
2012-05-14 02:00:00,0,1,1,1,2
2012-05-14 03:00:00,0,1,0,2,2
2012-05-14 04:00:00,0,1,3,3,6
2012-05-14 05:00:00,0,1,1,25,26
2012-05-14 06:00:00,0,1,3,62,65
2012-05-14 07:00:00,0,1,3,72,75
2012-05-14 08:00:00,0,1,1,155,156
2012-05-14 09:00:00,0,1,5,105,110
2012-05-14 10:00:00,0,1,6,53,59
2012-05-14 11:00:00,0,1,12,67,79
2012-05-14 12:00:00,0,1,53,132,185
2012-05-14 13:00:00,0,1,33,143,176
2012-05-14 14:00:00,0,1,43,128,171
2012-05-14 15:00:00,0,1,40,156,196
2012-05-14 16:00:00,0,1,20,91,111
2012-05-14 17:00:00,0,1,25,204,229
2012-05-14 18:00:00,0,1,17,283,300
2012-05-14 19:00:00,0,1,10,294,304
2012-05-14 20:00:00,0,1,11,178,189
2012-05-14 21:00:00,0,1,7,145,152
2012-05-14 22:00:00,0,1,11,118,129
2012-05-14 23:00:00,0,1,11,64,75
2012-05-15 00:00:00,0,1,7,25,32
2012-05-15 01:00:00,0,1,5,14,19
2012-05-15 02:00:00,0,1,1,3,4
2012-05-15 03:00:00,0,1,1,5,6
2012-05-15 04:00:00,0,1,1,4,5
2012-05-15 05:00:00,0,1,0,8,8
2012-05-15 06:00:00,0,1,2,22,24
2012-05-15 07:00:00,0,1,1,91,92
2012-05-15 08:00:00,0,1,8,401,409
2012-05-15 09:00:00,0,1,28,327,355
2012-05-15 10:00:00,0,1,27,144,171
2012-05-15 11:00:00,0,1,38,186,224
2012-05-15 12:00:00,0,1,44,220,264
2012-05-15 13:00:00,0,1,35,204,239
2012-05-15 14:00:00,0,1,39,145,184
2012-05-15 15:00:00,0,1,51,205,256
2012-05-15 16:00:00,0,1,74,300,374
2012-05-15 17:00:00,0,1,75,603,678
2012-05-15 18:00:00,0,1,68,665,733
2012-05-15 19:00:00,0,1,57,455,512
2012-05-15 20:00:00,0,1,30,233,263
2012-05-15 21:00:00,0,1,11,98,109
2012-05-15 22:00:00,0,1,9,74,83
2012-05-15 23:00:00,0,1,13,58,71
2012-05-16 00:00:00,0,1,12,27,39
2012-05-16 01:00:00,0,1,7,14,21
2012-05-16 02:00:00,0,1,5,14,19
2012-05-16 03:00:00,0,1,1,5,6
2012-05-16 04:00:00,0,1,1,3,4
2012-05-16 05:00:00,0,1,4,34,38
2012-05-16 06:00:00,0,1,8,150,158
2012-05-16 07:00:00,0,1,14,426,440
2012-05-16 08:00:00,0,1,33,617,650
2012-05-16 09:00:00,0,1,33,314,347
2012-05-16 10:00:00,0,1,43,149,192
2012-05-16 11:00:00,0,1,55,212,267
2012-05-16 12:00:00,0,1,59,271,330
2012-05-16 13:00:00,0,1,77,273,350
2012-05-16 14:00:00,0,1,42,221,263
2012-05-16 15:00:00,0,1,52,222,274
2012-05-16 16:00:00,0,1,70,376,446
2012-05-16 17:00:00,0,1,104,769,873
2012-05-16 18:00:00,0,1,97,749,846
2012-05-16 19:00:00,0,1,91,499,590
2012-05-16 20:00:00,0,1,61,398,459
2012-05-16 21:00:00,0,1,63,330,393
2012-05-16 22:00:00,0,1,33,253,286
2012-05-16 23:00:00,0,1,26,107,133
2012-05-17 00:00:00,0,1,30,49,79
2012-05-17 01:00:00,0,1,12,16,28
2012-05-17 02:00:00,0,1,8,8,16
2012-05-17 03:00:00,0,1,0,3,3
2012-05-17 04:00:00,0,1,3,13,16
2012-05-17 05:00:00,0,1,1,34,35
2012-05-17 06:00:00,0,1,10,149,159
2012-05-17 07:00:00,0,1,25,449,474
2012-05-17 08:00:00,0,1,29,605,634
2012-05-17 09:00:00,0,1,57,289,346
2012-05-17 10:00:00,0,1,43,162,205
2012-05-17 11:00:00,0,1,77,202,279
2012-05-17 12:00:00,0,1,72,276,348
2012-05-17 13:00:00,0,1,86,241,327
2012-05-17 14:00:00,0,1,68,202,270
2012-05-17 15:00:00,0,1,83,233,316
2012-05-17 16:00:00,0,1,86,344,430
2012-05-17 17:00:00,0,1,133,719,852
2012-05-17 18:00:00,0,1,134,734,868
2012-05-17 19:00:00,0,1,86,451,537
2012-05-17 20:00:00,0,1,83,363,446
2012-05-17 21:00:00,0,1,45,254,299
2012-05-17 22:00:00,0,1,42,209,251
2012-05-17 23:00:00,0,1,29,137,166
2012-05-18 00:00:00,0,1,13,57,70
2012-05-18 01:00:00,0,1,16,33,49
2012-05-18 02:00:00,0,1,12,9,21
2012-05-18 03:00:00,0,1,6,8,14
2012-05-18 04:00:00,0,1,0,11,11
2012-05-18 05:00:00,0,1,1,33,34
2012-05-18 06:00:00,0,1,14,168,182
2012-05-18 07:00:00,0,1,40,475,515
2012-05-18 08:00:00,0,1,49,696,745
2012-05-18 09:00:00,0,1,57,304,361
2012-05-18 10:00:00,0,1,74,181,255
2012-05-18 11:00:00,0,1,109,225,334
2012-05-18 12:00:00,0,1,108,252,360
2012-05-18 13:00:00,0,1,98,297,395
2012-05-18 14:00:00,0,1,108,242,350
2012-05-18 15:00:00,0,1,131,260,391
2012-05-18 16:00:00,0,1,151,417,568
2012-05-18 17:00:00,0,1,124,688,812
2012-05-18 18:00:00,0,1,99,570,669
2012-05-18 19:00:00,0,1,91,392,483
2012-05-18 20:00:00,0,1,73,264,337
2012-05-18 21:00:00,0,1,49,209,258
2012-05-18 22:00:00,0,1,57,194,251
2012-05-18 23:00:00,0,1,41,133,174
2012-05-19 00:00:00,0,0,30,118,148
2012-05-19 01:00:00,0,0,20,84,104
2012-05-19 02:00:00,0,0,13,56,69
2012-05-19 03:00:00,0,0,10,23,33
2012-05-19 04:00:00,0,0,6,8,14
2012-05-19 05:00:00,0,0,1,11,12
2012-05-19 06:00:00,0,0,12,38,50
2012-05-19 07:00:00,0,0,28,67,95
2012-05-19 08:00:00,0,0,33,162,195
2012-05-19 09:00:00,0,0,79,213,292
2012-05-19 10:00:00,0,0,177,275,452
2012-05-19 11:00:00,0,0,235,351,586
2012-05-19 12:00:00,0,0,276,366,642
2012-05-19 13:00:00,0,0,332,372,704
2012-05-19 14:00:00,0,0,361,369,730
2012-05-19 15:00:00,0,0,356,316,672
2012-05-19 16:00:00,0,0,331,311,642
2012-05-19 17:00:00,0,0,279,347,626
2012-05-19 18:00:00,0,0,254,391,645
2012-05-19 19:00:00,0,0,203,229,432
2012-05-19 20:00:00,0,0,118,197,315
2012-05-19 21:00:00,0,0,81,178,259
2012-05-19 22:00:00,0,0,104,234,338
2012-05-19 23:00:00,0,0,71,168,239
2012-06-01 00:00:00,0,1,10,76,86
2012-06-01 01:00:00,0,1,0,34,34
2012-06-01 02:00:00,0,1,3,13,16
2012-06-01 03:00:00,0,1,0,4,4
2012-06-01 04:00:00,0,1,1,5,6
2012-06-01 05:00:00,0,1,4,41,45
2012-06-01 06:00:00,0,1,5,136,141
2012-06-01 07:00:00,0,1,33,369,402
2012-06-01 08:00:00,0,1,19,675,694
2012-06-01 09:00:00,0,1,24,274,298
2012-06-01 10:00:00,0,1,49,155,204
2012-06-01 11:00:00,0,1,42,193,235
2012-06-01 12:00:00,0,1,72,238,310
2012-06-01 13:00:00,0,1,76,240,316
2012-06-01 14:00:00,0,1,55,199,254
2012-06-01 15:00:00,0,1,45,213,258
2012-06-01 16:00:00,0,1,36,186,222
2012-06-01 17:00:00,0,1,25,202,227
2012-06-01 18:00:00,0,1,10,100,110
2012-06-01 19:00:00,0,1,4,41,45
2012-06-01 20:00:00,0,1,1,38,39
2012-06-01 21:00:00,0,1,12,73,85
2012-06-01 22:00:00,0,1,1,22,23
2012-06-01 23:00:00,0,1,6,67,73
2012-06-02 00:00:00,0,0,5,81,86
2012-06-02 01:00:00,0,0,15,61,76
2012-06-02 02:00:00,0,0,3,38,41
2012-06-02 03:00:00,0,0,8,18,26
2012-06-02 04:00:00,0,0,2,11,13
2012-06-02 05:00:00,0,0,1,11,12
2012-06-02 06:00:00,0,0,5,31,36
2012-06-02 07:00:00,0,0,9,77,86
2012-06-02 08:00:00,0,0,30,180,210
2012-06-02 09:00:00,0,0,89,243,332
2012-06-02 10:00:00,0,0,145,348,493
2012-06-02 11:00:00,0,0,179,357,536
2012-06-02 12:00:00,0,0,250,418,668
2012-06-02 13:00:00,0,0,279,400,679
2012-06-02 14:00:00,0,0,259,388,647
2012-06-02 15:00:00,0,0,297,405,702
2012-06-02 16:00:00,0,0,275,369,644
2012-06-02 17:00:00,0,0,248,338,586
2012-06-02 18:00:00,0,0,171,341,512
2012-06-02 19:00:00,0,0,185,369,554
2012-06-02 20:00:00,0,0,139,260,399
2012-06-02 21:00:00,0,0,96,220,316
2012-06-02 22:00:00,0,0,52,176,228
2012-06-02 23:00:00,0,0,53,185,238
2012-06-03 00:00:00,0,0,27,142,169
2012-06-03 01:00:00,0,0,21,100,121
2012-06-03 02:00:00,0,0,22,67,89
2012-06-03 03:00:00,0,0,16,34,50
2012-06-03 04:00:00,0,0,1,12,13
2012-06-03 05:00:00,0,0,1,11,12
2012-06-03 06:00:00,0,0,6,16,22
2012-06-03 07:00:00,0,0,6,29,35
2012-06-03 08:00:00,0,0,30,110,140
2012-06-03 09:00:00,0,0,70,230,300
2012-06-03 10:00:00,0,0,127,277,404
2012-06-03 11:00:00,0,0,199,312,511
2012-06-03 12:00:00,0,0,276,408,684
2012-06-03 13:00:00,0,0,265,421,686
2012-06-03 14:00:00,0,0,267,411,678
2012-06-03 15:00:00,0,0,236,408,644
2012-06-03 16:00:00,0,0,226,436,662
2012-06-03 17:00:00,0,0,192,386,578
2012-06-03 18:00:00,0,0,153,343,496
2012-06-03 19:00:00,0,0,116,337,453
2012-06-03 20:00:00,0,0,84,230,314
2012-06-03 21:00:00,0,0,66,180,246
2012-06-03 22:00:00,0,0,61,165,226
2012-06-03 23:00:00,0,0,26,82,108
2012-06-04 00:00:00,0,1,11,38,49
2012-06-04 01:00:00,0,1,4,10,14
2012-06-04 02:00:00,0,1,1,10,11
2012-06-04 03:00:00,0,1,0,5,5
2012-06-04 04:00:00,0,1,2,6,8
2012-06-04 05:00:00,0,1,2,33,35
2012-06-04 06:00:00,0,1,4,135,139
2012-06-04 07:00:00,0,1,13,504,517
2012-06-04 08:00:00,0,1,22,643,665
2012-06-04 09:00:00,0,1,38,244,282
2012-06-04 10:00:00,0,1,67,120,187
2012-06-04 11:00:00,0,1,71,168,239
2012-06-04 12:00:00,0,1,62,220,282
2012-06-04 13:00:00,0,1,85,189,274
2012-06-04 14:00:00,0,1,84,186,270
2012-06-04 15:00:00,0,1,77,215,292
2012-06-04 16:00:00,0,1,73,375,448
2012-06-04 17:00:00,0,1,101,733,834
2012-06-04 18:00:00,0,1,103,719,822
2012-06-04 19:00:00,0,1,91,554,645
2012-06-04 20:00:00,0,1,71,390,461
2012-06-04 21:00:00,0,1,40,225,265
2012-06-04 22:00:00,0,1,41,127,168
2012-06-04 23:00:00,0,1,8,78,86
2012-06-05 00:00:00,0,1,6,28,34
2012-06-05 01:00:00,0,1,2,18,20
2012-06-05 02:00:00,0,1,0,8,8
2012-06-05 03:00:00,0,1,0,5,5
2012-06-05 04:00:00,0,1,1,4,5
2012-06-05 05:00:00,0,1,1,35,36
2012-06-05 06:00:00,0,1,7,177,184
2012-06-05 07:00:00,0,1,29,540,569
2012-06-05 08:00:00,0,1,30,680,710
2012-06-05 09:00:00,0,1,50,285,335
2012-06-05 10:00:00,0,1,58,118,176
2012-06-05 11:00:00,0,1,65,162,227
2012-06-05 12:00:00,0,1,45,202,247
2012-06-05 13:00:00,0,1,66,201,267
2012-06-05 14:00:00,0,1,82,194,276
2012-06-05 15:00:00,0,1,54,218,272
2012-06-05 16:00:00,0,1,91,382,473
2012-06-05 17:00:00,0,1,86,764,850
2012-06-05 18:00:00,0,1,111,679,790
2012-06-05 19:00:00,0,1,68,445,513
2012-06-05 20:00:00,0,1,44,371,415
2012-06-05 21:00:00,0,1,30,253,283
2012-06-05 22:00:00,0,1,22,171,193
2012-06-05 23:00:00,0,1,20,93,113
2012-06-06 00:00:00,0,1,3,46,49
2012-06-06 01:00:00,0,1,6,21,27
2012-06-06 02:00:00,0,1,4,7,11
2012-06-06 03:00:00,0,1,0,8,8
2012-06-06 04:00:00,0,1,3,7,10
2012-06-06 05:00:00,0,1,1,37,38
2012-06-06 06:00:00,0,1,7,165,172
2012-06-06 07:00:00,0,1,16,531,547
2012-06-06 08:00:00,0,1,31,637,668
2012-06-06 09:00:00,0,1,35,268,303
2012-06-06 10:00:00,0,1,55,148,203
2012-06-06 11:00:00,0,1,65,161,226
2012-06-06 12:00:00,0,1,80,235,315
2012-06-06 13:00:00,0,1,73,230,303
2012-06-06 14:00:00,0,1,111,191,302
2012-06-06 15:00:00,0,1,75,225,300
2012-06-06 16:00:00,0,1,107,345,452
2012-06-06 17:00:00,0,1,72,652,724
2012-06-06 18:00:00,0,1,94,688,782
2012-06-06 19:00:00,0,1,52,486,538
2012-06-06 20:00:00,0,1,59,349,408
2012-06-06 21:00:00,0,1,38,260,298
2012-06-06 22:00:00,0,1,27,221,248
2012-06-06 23:00:00,0,1,13,110,123
2012-06-07 00:00:00,0,1,9,50,59
2012-06-07 01:00:00,0,1,5,17,22
2012-06-07 02:00:00,0,1,0,12,12
2012-06-07 03:00:00,0,1,0,5,5
2012-06-07 04:00:00,0,1,0,6,6
2012-06-07 05:00:00,0,1,0,34,34
2012-06-07 06:00:00,0,1,5,165,170
2012-06-07 07:00:00,0,1,20,506,526
2012-06-07 08:00:00,0,1,20,661,681
2012-06-07 09:00:00,0,1,37,300,337
2012-06-07 10:00:00,0,1,56,154,210
2012-06-07 11:00:00,0,1,67,170,237
2012-06-07 12:00:00,0,1,62,274,336
2012-06-07 13:00:00,0,1,65,250,315
2012-06-07 14:00:00,0,1,67,198,265
2012-06-07 15:00:00,0,1,99,234,333
2012-06-07 16:00:00,0,1,77,389,466
2012-06-07 17:00:00,0,1,91,778,869
2012-06-07 18:00:00,0,1,110,703,813
2012-06-07 19:00:00,0,1,65,537,602
2012-06-07 20:00:00,0,1,76,402,478
2012-06-07 21:00:00,0,1,30,283,313
2012-06-07 22:00:00,0,1,35,193,228
2012-06-07 23:00:00,0,1,42,135,177
2012-06-08 00:00:00,0,1,18,59,77
2012-06-08 01:00:00,0,1,4,25,29
2012-06-08 02:00:00,0,1,2,17,19
2012-06-08 03:00:00,0,1,0,8,8
2012-06-08 04:00:00,0,1,1,9,10
2012-06-08 05:00:00,0,1,1,28,29
2012-06-08 06:00:00,0,1,8,131,139
2012-06-08 07:00:00,0,1,19,409,428
2012-06-08 08:00:00,0,1,37,663,700
2012-06-08 09:00:00,0,1,47,335,382
2012-06-08 10:00:00,0,1,62,187,249
2012-06-08 11:00:00,0,1,65,199,264
2012-06-08 12:00:00,0,1,89,280,369
2012-06-08 13:00:00,0,1,129,287,416
2012-06-08 14:00:00,0,1,128,245,373
2012-06-08 15:00:00,0,1,98,299,397
2012-06-08 16:00:00,0,1,111,412,523
2012-06-08 17:00:00,0,1,114,679,793
2012-06-08 18:00:00,0,1,147,576,723
2012-06-08 19:00:00,0,1,95,460,555
2012-06-08 20:00:00,0,1,117,291,408
2012-06-08 21:00:00,0,1,83,256,339
2012-06-08 22:00:00,0,1,61,230,291
2012-06-08 23:00:00,0,1,52,163,215
2012-06-09 00:00:00,0,0,54,152,206
2012-06-09 01:00:00,0,0,34,89,123
2012-06-09 02:00:00,0,0,21,68,89
2012-06-09 03:00:00,0,0,12,28,40
2012-06-09 04:00:00,0,0,2,6,8
2012-06-09 05:00:00,0,0,4,15,19
2012-06-09 06:00:00,0,0,17,63,80
2012-06-09 07:00:00,0,0,26,61,87
2012-06-09 08:00:00,0,0,42,202,244
2012-06-09 09:00:00,0,0,99,241,340
2012-06-09 10:00:00,0,0,168,298,466
2012-06-09 11:00:00,0,0,218,351,569
2012-06-09 12:00:00,0,0,196,335,531
2012-06-09 13:00:00,0,0,236,349,585
2012-06-09 14:00:00,0,0,239,354,593
2012-06-09 15:00:00,0,0,218,337,555
2012-06-09 16:00:00,0,0,219,315,534
2012-06-09 17:00:00,0,0,238,257,495
2012-06-09 18:00:00,0,0,175,276,451
2012-06-09 19:00:00,0,0,128,232,360
2012-06-09 20:00:00,0,0,125,238,363
2012-06-09 21:00:00,0,0,105,211,316
2012-06-09 22:00:00,0,0,63,151,214
2012-06-09 23:00:00,0,0,69,161,230
2012-06-10 00:00:00,0,0,33,125,158
2012-06-10 01:00:00,0,0,32,84,116
2012-06-10 02:00:00,0,0,17,56,73
2012-06-10 03:00:00,0,0,6,23,29
2012-06-10 04:00:00,0,0,1,9,10
2012-06-10 05:00:00,0,0,3,10,13
2012-06-10 06:00:00,0,0,3,27,30
2012-06-10 07:00:00,0,0,21,41,62
2012-06-10 08:00:00,0,0,59,122,181
2012-06-10 09:00:00,0,0,91,175,266
2012-06-10 10:00:00,0,0,148,265,413
2012-06-10 11:00:00,0,0,184,315,499
2012-06-10 12:00:00,0,0,173,329,502
2012-06-10 13:00:00,0,0,204,288,492
2012-06-10 14:00:00,0,0,186,314,500
2012-06-10 15:00:00,0,0,159,316,475
2012-06-10 16:00:00,0,0,173,335,508
2012-06-10 17:00:00,0,0,184,337,521
2012-06-10 18:00:00,0,0,164,326,490
2012-06-10 19:00:00,0,0,115,260,375
2012-06-10 20:00:00,0,0,113,250,363
2012-06-10 21:00:00,0,0,83,170,253
2012-06-10 22:00:00,0,0,42,117,159
2012-06-10 23:00:00,0,0,30,80,110
2012-06-11 00:00:00,0,1,8,33,41
2012-06-11 01:00:00,0,1,9,15,24
2012-06-11 02:00:00,0,1,5,12,17
2012-06-11 03:00:00,0,1,2,4,6
2012-06-11 04:00:00,0,1,0,7,7
2012-06-11 05:00:00,0,1,1,36,37
2012-06-11 06:00:00,0,1,8,136,144
2012-06-11 07:00:00,0,1,25,478,503
2012-06-11 08:00:00,0,1,38,613,651
2012-06-11 09:00:00,0,1,57,259,316
2012-06-11 10:00:00,0,1,52,95,147
2012-06-11 11:00:00,0,1,59,143,202
2012-06-11 12:00:00,0,1,63,198,261
2012-06-11 13:00:00,0,1,63,185,248
2012-06-11 14:00:00,0,1,66,193,259
2012-06-11 15:00:00,0,1,72,187,259
2012-06-11 16:00:00,0,1,87,340,427
2012-06-11 17:00:00,0,1,85,715,800
2012-06-11 18:00:00,0,1,105,726,831
2012-06-11 19:00:00,0,1,89,507,596
2012-06-11 20:00:00,0,1,61,333,394
2012-06-11 21:00:00,0,1,32,218,250
2012-06-11 22:00:00,0,1,22,142,164
2012-06-11 23:00:00,0,1,8,72,80
2012-06-12 00:00:00,0,1,2,26,28
2012-06-12 01:00:00,0,1,5,11,16
2012-06-12 02:00:00,0,1,0,6,6
2012-06-12 03:00:00,0,1,3,9,12
2012-06-12 04:00:00,0,1,0,4,4
2012-06-12 05:00:00,0,1,1,28,29
2012-06-12 06:00:00,0,1,6,130,136
2012-06-12 07:00:00,0,1,16,287,303
2012-06-12 08:00:00,0,1,15,598,613
2012-06-12 09:00:00,0,1,31,254,285
2012-06-12 10:00:00,0,1,29,96,125
2012-06-12 11:00:00,0,1,8,57,65
2012-06-12 12:00:00,0,1,19,76,95
2012-06-12 13:00:00,0,1,11,48,59
2012-06-12 14:00:00,0,1,12,48,60
2012-06-12 15:00:00,0,1,22,94,116
2012-06-12 16:00:00,0,1,30,209,239
2012-06-12 17:00:00,0,1,56,625,681
2012-06-12 18:00:00,0,1,57,596,653
2012-06-12 19:00:00,0,1,47,444,491
2012-06-12 20:00:00,0,1,36,350,386
2012-06-12 21:00:00,0,1,41,233,274
2012-06-12 22:00:00,0,1,19,188,207
2012-06-12 23:00:00,0,1,11,78,89
2012-06-13 00:00:00,0,1,7,27,34
2012-06-13 01:00:00,0,1,7,21,28
2012-06-13 02:00:00,0,1,0,4,4
2012-06-13 03:00:00,0,1,1,7,8
2012-06-13 04:00:00,0,1,1,9,10
2012-06-13 05:00:00,0,1,2,38,40
2012-06-13 06:00:00,0,1,6,188,194
2012-06-13 07:00:00,0,1,25,480,505
2012-06-13 08:00:00,0,1,41,672,713
2012-06-13 09:00:00,0,1,54,298,352
2012-06-13 10:00:00,0,1,64,134,198
2012-06-13 11:00:00,0,1,64,182,246
2012-06-13 12:00:00,0,1,93,241,334
2012-06-13 13:00:00,0,1,52,203,255
2012-06-13 14:00:00,0,1,98,222,320
2012-06-13 15:00:00,0,1,65,216,281
2012-06-13 16:00:00,0,1,72,320,392
2012-06-13 17:00:00,0,1,75,782,857
2012-06-13 18:00:00,0,1,104,640,744
2012-06-13 19:00:00,0,1,123,548,671
2012-06-13 20:00:00,0,1,86,362,448
2012-06-13 21:00:00,0,1,79,317,396
2012-06-13 22:00:00,0,1,29,209,238
2012-06-13 23:00:00,0,1,25,128,153
2012-06-14 00:00:00,0,1,3,45,48
2012-06-14 01:00:00,0,1,4,17,21
2012-06-14 02:00:00,0,1,1,8,9
2012-06-14 03:00:00,0,1,1,4,5
2012-06-14 04:00:00,0,1,0,6,6
2012-06-14 05:00:00,0,1,0,40,40
2012-06-14 06:00:00,0,1,12,169,181
2012-06-14 07:00:00,0,1,26,480,506
2012-06-14 08:00:00,0,1,37,682,719
2012-06-14 09:00:00,0,1,45,312,357
2012-06-14 10:00:00,0,1,47,132,179
2012-06-14 11:00:00,0,1,60,168,228
2012-06-14 12:00:00,0,1,55,210,265
2012-06-14 13:00:00,0,1,71,213,284
2012-06-14 14:00:00,0,1,84,214,298
2012-06-14 15:00:00,0,1,111,213,324
2012-06-14 16:00:00,0,1,70,368,438
2012-06-14 17:00:00,0,1,117,750,867
2012-06-14 18:00:00,0,1,107,716,823
2012-06-14 19:00:00,0,1,96,483,579
2012-06-14 20:00:00,0,1,84,351,435
2012-06-14 21:00:00,0,1,67,270,337
2012-06-14 22:00:00,0,1,46,196,242
2012-06-14 23:00:00,0,1,36,136,172
2012-06-15 00:00:00,0,1,26,68,94
2012-06-15 01:00:00,0,1,9,42,51
2012-06-15 02:00:00,0,1,0,15,15
2012-06-15 03:00:00,0,1,2,3,5
2012-06-15 04:00:00,0,1,1,13,14
2012-06-15 05:00:00,0,1,2,31,33
2012-06-15 06:00:00,0,1,9,142,151
2012-06-15 07:00:00,0,1,17,413,430
2012-06-15 08:00:00,0,1,44,609,653
2012-06-15 09:00:00,0,1,58,308,366
2012-06-15 10:00:00,0,1,56,160,216
2012-06-15 11:00:00,0,1,106,180,286
2012-06-15 12:00:00,0,1,111,292,403
2012-06-15 13:00:00,0,1,121,272,393
2012-06-15 14:00:00,0,1,121,255,376
2012-06-15 15:00:00,0,1,107,270,377
2012-06-15 16:00:00,0,1,132,426,558
2012-06-15 17:00:00,0,1,125,698,823
2012-06-15 18:00:00,0,1,121,572,693
2012-06-15 19:00:00,0,1,98,369,467
2012-06-15 20:00:00,0,1,89,296,385
2012-06-15 21:00:00,0,1,83,250,333
2012-06-15 22:00:00,0,1,79,242,321
2012-06-15 23:00:00,0,1,46,176,222
2012-06-16 00:00:00,0,0,25,112,137
2012-06-16 01:00:00,0,0,16,79,95
2012-06-16 02:00:00,0,0,12,55,67
2012-06-16 03:00:00,0,0,8,19,27
2012-06-16 04:00:00,0,0,3,5,8
2012-06-16 05:00:00,0,0,2,21,23
2012-06-16 06:00:00,0,0,11,36,47
2012-06-16 07:00:00,0,0,10,68,78
2012-06-16 08:00:00,0,0,47,157,204
2012-06-16 09:00:00,0,0,88,279,367
2012-06-16 10:00:00,0,0,139,296,435
2012-06-16 11:00:00,0,0,213,353,566
2012-06-16 12:00:00,0,0,254,349,603
2012-06-16 13:00:00,0,0,293,324,617
2012-06-16 14:00:00,0,0,264,309,573
2012-06-16 15:00:00,0,0,295,288,583
2012-06-16 16:00:00,0,0,238,304,542
2012-06-16 17:00:00,0,0,244,349,593
2012-06-16 18:00:00,0,0,256,315,571
2012-06-16 19:00:00,0,0,184,277,461
2012-06-16 20:00:00,0,0,123,229,352
2012-06-16 21:00:00,0,0,98,192,290
2012-06-16 22:00:00,0,0,91,189,280
2012-06-16 23:00:00,0,0,49,134,183
2012-06-17 00:00:00,0,0,31,117,148
2012-06-17 01:00:00,0,0,21,67,88
2012-06-17 02:00:00,0,0,19,55,74
2012-06-17 03:00:00,0,0,6,22,28
2012-06-17 04:00:00,0,0,2,16,18
2012-06-17 05:00:00,0,0,4,13,17
2012-06-17 06:00:00,0,0,7,16,23
2012-06-17 07:00:00,0,0,18,30,48
2012-06-17 08:00:00,0,0,24,95,119
2012-06-17 09:00:00,0,0,91,183,274
2012-06-17 10:00:00,0,0,148,288,436
2012-06-17 11:00:00,0,0,196,350,546
2012-06-17 12:00:00,0,0,260,355,615
2012-06-17 13:00:00,0,0,267,347,614
2012-06-17 14:00:00,0,0,255,327,582
2012-06-17 15:00:00,0,0,203,260,463
2012-06-17 16:00:00,0,0,240,340,580
2012-06-17 17:00:00,0,0,232,361,593
2012-06-17 18:00:00,0,0,203,310,513
2012-06-17 19:00:00,0,0,146,244,390
2012-06-17 20:00:00,0,0,101,201,302
2012-06-17 21:00:00,0,0,76,170,246
2012-06-17 22:00:00,0,0,55,98,153
2012-06-17 23:00:00,0,0,29,79,108
2012-06-18 00:00:00,0,1,12,28,40
2012-06-18 01:00:00,0,1,9,5,14
2012-06-18 02:00:00,0,1,3,6,9
2012-06-18 03:00:00,0,1,1,3,4
2012-06-18 04:00:00,0,1,0,9,9
2012-06-18 05:00:00,0,1,1,22,23
2012-06-18 06:00:00,0,1,0,37,37
2012-06-18 07:00:00,0,1,10,135,145
2012-06-18 08:00:00,0,1,27,447,474
2012-06-18 09:00:00,0,1,28,222,250
2012-06-18 10:00:00,0,1,13,78,91
2012-06-18 11:00:00,0,1,25,96,121
2012-06-18 12:00:00,0,1,29,139,168
2012-06-18 13:00:00,0,1,51,174,225
2012-06-18 14:00:00,0,1,59,160,219
2012-06-18 15:00:00,0,1,61,176,237
2012-06-18 16:00:00,0,1,53,279,332
2012-06-18 17:00:00,0,1,54,669,723
2012-06-18 18:00:00,0,1,47,595,642
2012-06-18 19:00:00,0,1,52,411,463
2012-06-18 20:00:00,0,1,45,317,362
2012-06-18 21:00:00,0,1,35,238,273
2012-06-18 22:00:00,0,1,21,143,164
2012-06-18 23:00:00,0,1,17,57,74
2012-06-19 00:00:00,0,1,5,30,35
2012-06-19 01:00:00,0,1,1,13,14
2012-06-19 02:00:00,0,1,1,14,15
2012-06-19 03:00:00,0,1,1,7,8
2012-06-19 04:00:00,0,1,1,9,10
2012-06-19 05:00:00,0,1,3,34,37
2012-06-19 06:00:00,0,1,9,152,161
2012-06-19 07:00:00,0,1,18,462,480
2012-06-19 08:00:00,0,1,40,633,673
2012-06-19 09:00:00,0,1,40,288,328
2012-06-19 10:00:00,0,1,44,136,180
2012-06-19 11:00:00,0,1,56,174,230
2012-06-19 12:00:00,0,1,70,222,292
2012-06-19 13:00:00,0,1,69,203,272
2012-06-19 14:00:00,0,1,61,166,227
2012-06-19 15:00:00,0,1,72,187,259
2012-06-19 16:00:00,0,1,48,286,334
2012-06-19 17:00:00,0,1,86,725,811
2012-06-19 18:00:00,0,1,91,704,795
2012-06-19 19:00:00,0,1,82,432,514
2012-06-19 20:00:00,0,1,59,399,458
2012-06-19 21:00:00,0,1,37,239,276
2012-06-19 22:00:00,0,1,51,240,291
2012-06-19 23:00:00,0,1,23,102,125
2012-07-01 00:00:00,0,0,27,122,149
2012-07-01 01:00:00,0,0,12,81,93
2012-07-01 02:00:00,0,0,21,69,90
2012-07-01 03:00:00,0,0,6,27,33
2012-07-01 04:00:00,0,0,0,4,4
2012-07-01 05:00:00,0,0,3,7,10
2012-07-01 06:00:00,0,0,8,19,27
2012-07-01 07:00:00,0,0,13,37,50
2012-07-01 08:00:00,0,0,36,106,142
2012-07-01 09:00:00,0,0,51,168,219
2012-07-01 10:00:00,0,0,98,268,366
2012-07-01 11:00:00,0,0,121,256,377
2012-07-01 12:00:00,0,0,114,319,433
2012-07-01 13:00:00,0,0,111,309,420
2012-07-01 14:00:00,0,0,98,346,444
2012-07-01 15:00:00,0,0,101,244,345
2012-07-01 16:00:00,0,0,85,228,313
2012-07-01 17:00:00,0,0,90,323,413
2012-07-01 18:00:00,0,0,95,275,370
2012-07-01 19:00:00,0,0,103,279,382
2012-07-01 20:00:00,0,0,88,244,332
2012-07-01 21:00:00,0,0,77,181,258
2012-07-01 22:00:00,0,0,41,110,151
2012-07-01 23:00:00,0,0,22,88,110
2012-07-02 00:00:00,0,1,12,31,43
2012-07-02 01:00:00,0,1,3,14,17
2012-07-02 02:00:00,0,1,1,14,15
2012-07-02 03:00:00,0,1,0,5,5
2012-07-02 04:00:00,0,1,2,10,12
2012-07-02 05:00:00,0,1,3,37,40
2012-07-02 06:00:00,0,1,4,132,136
2012-07-02 07:00:00,0,1,8,390,398
2012-07-02 08:00:00,0,1,20,548,568
2012-07-02 09:00:00,0,1,56,239,295
2012-07-02 10:00:00,0,1,70,104,174
2012-07-02 11:00:00,0,1,67,134,201
2012-07-02 12:00:00,0,1,74,183,257
2012-07-02 13:00:00,0,1,74,162,236
2012-07-02 14:00:00,0,1,79,151,230
2012-07-02 15:00:00,0,1,59,175,234
2012-07-02 16:00:00,0,1,61,304,365
2012-07-02 17:00:00,0,1,82,665,747
2012-07-02 18:00:00,0,1,72,658,730
2012-07-02 19:00:00,0,1,71,510,581
2012-07-02 20:00:00,0,1,38,357,395
2012-07-02 21:00:00,0,1,17,241,258
2012-07-02 22:00:00,0,1,19,169,188
2012-07-02 23:00:00,0,1,12,90,102
2012-07-03 00:00:00,0,1,9,44,53
2012-07-03 01:00:00,0,1,5,9,14
2012-07-03 02:00:00,0,1,2,8,10
2012-07-03 03:00:00,0,1,0,2,2
2012-07-03 04:00:00,0,1,0,6,6
2012-07-03 05:00:00,0,1,2,33,35
2012-07-03 06:00:00,0,1,5,149,154
2012-07-03 07:00:00,0,1,21,462,483
2012-07-03 08:00:00,0,1,42,604,646
2012-07-03 09:00:00,0,1,46,226,272
2012-07-03 10:00:00,0,1,56,153,209
2012-07-03 11:00:00,0,1,66,151,217
2012-07-03 12:00:00,0,1,74,198,272
2012-07-03 13:00:00,0,1,80,203,283
2012-07-03 14:00:00,0,1,69,241,310
2012-07-03 15:00:00,0,1,71,330,401
2012-07-03 16:00:00,0,1,90,437,527
2012-07-03 17:00:00,0,1,102,620,722
2012-07-03 18:00:00,0,1,85,542,627
2012-07-03 19:00:00,0,1,66,431,497
2012-07-03 20:00:00,0,1,80,296,376
2012-07-03 21:00:00,0,1,36,160,196
2012-07-03 22:00:00,0,1,26,151,177
2012-07-03 23:00:00,0,1,19,152,171
2012-07-04 00:00:00,1,0,19,140,159
2012-07-04 01:00:00,1,0,27,96,123
2012-07-04 02:00:00,1,0,27,66,93
2012-07-04 03:00:00,1,0,9,23,32
2012-07-04 04:00:00,1,0,5,11,16
2012-07-04 05:00:00,1,0,5,14,19
2012-07-04 06:00:00,1,0,9,23,32
2012-07-04 07:00:00,1,0,10,62,72
2012-07-04 08:00:00,1,0,43,110,153
2012-07-04 09:00:00,1,0,90,203,293
2012-07-04 10:00:00,1,0,143,304,447
2012-07-04 11:00:00,1,0,164,321,485
2012-07-04 12:00:00,1,0,164,330,494
2012-07-04 13:00:00,1,0,177,322,499
2012-07-04 14:00:00,1,0,190,357,547
2012-07-04 15:00:00,1,0,155,299,454
2012-07-04 16:00:00,1,0,163,226,389
2012-07-04 17:00:00,1,0,161,253,414
2012-07-04 18:00:00,1,0,159,271,430
2012-07-04 19:00:00,1,0,177,255,432
2012-07-04 20:00:00,1,0,237,314,551
2012-07-04 21:00:00,1,0,222,362,584
2012-07-04 22:00:00,1,0,175,327,502
2012-07-04 23:00:00,1,0,31,152,183
2012-07-05 00:00:00,0,1,17,71,88
2012-07-05 01:00:00,0,1,6,24,30
2012-07-05 02:00:00,0,1,4,14,18
2012-07-05 03:00:00,0,1,2,5,7
2012-07-05 04:00:00,0,1,0,7,7
2012-07-05 05:00:00,0,1,1,28,29
2012-07-05 06:00:00,0,1,3,130,133
2012-07-05 07:00:00,0,1,27,316,343
2012-07-05 08:00:00,0,1,36,514,550
2012-07-05 09:00:00,0,1,47,246,293
2012-07-05 10:00:00,0,1,69,117,186
2012-07-05 11:00:00,0,1,107,137,244
2012-07-05 12:00:00,0,1,88,188,276
2012-07-05 13:00:00,0,1,129,181,310
2012-07-05 14:00:00,0,1,87,154,241
2012-07-05 15:00:00,0,1,71,183,254
2012-07-05 16:00:00,0,1,109,324,433
2012-07-05 17:00:00,0,1,114,575,689
2012-07-05 18:00:00,0,1,96,511,607
2012-07-05 19:00:00,0,1,128,375,503
2012-07-05 20:00:00,0,1,78,243,321
2012-07-05 21:00:00,0,1,91,232,323
2012-07-05 22:00:00,0,1,63,162,225
2012-07-05 23:00:00,0,1,32,99,131
2012-07-06 00:00:00,0,1,39,63,102
2012-07-06 01:00:00,0,1,7,22,29
2012-07-06 02:00:00,0,1,4,13,17
2012-07-06 03:00:00,0,1,1,6,7
2012-07-06 04:00:00,0,1,2,4,6
2012-07-06 05:00:00,0,1,4,31,35
2012-07-06 06:00:00,0,1,4,127,131
2012-07-06 07:00:00,0,1,20,333,353
2012-07-06 08:00:00,0,1,28,557,585
2012-07-06 09:00:00,0,1,55,249,304
2012-07-06 10:00:00,0,1,80,130,210
2012-07-06 11:00:00,0,1,92,141,233
2012-07-06 12:00:00,0,1,111,220,331
2012-07-06 13:00:00,0,1,99,194,293
2012-07-06 14:00:00,0,1,91,184,275
2012-07-06 15:00:00,0,1,79,206,285
2012-07-06 16:00:00,0,1,69,300,369
2012-07-06 17:00:00,0,1,90,486,576
2012-07-06 18:00:00,0,1,106,454,560
2012-07-06 19:00:00,0,1,112,306,418
2012-07-06 20:00:00,0,1,91,245,336
2012-07-06 21:00:00,0,1,77,223,300
2012-07-06 22:00:00,0,1,78,210,288
2012-07-06 23:00:00,0,1,27,137,164
2012-07-07 00:00:00,0,0,35,115,150
2012-07-07 01:00:00,0,0,16,55,71
2012-07-07 02:00:00,0,0,11,47,58
2012-07-07 03:00:00,0,0,12,19,31
2012-07-07 04:00:00,0,0,3,13,16
2012-07-07 05:00:00,0,0,2,12,14
2012-07-07 06:00:00,0,0,4,27,31
2012-07-07 07:00:00,0,0,8,63,71
2012-07-07 08:00:00,0,0,32,120,152
2012-07-07 09:00:00,0,0,69,187,256
2012-07-07 10:00:00,0,0,100,225,325
2012-07-07 11:00:00,0,0,122,245,367
2012-07-07 12:00:00,0,0,124,218,342
2012-07-07 13:00:00,0,0,116,244,360
2012-07-07 14:00:00,0,0,105,203,308
2012-07-07 15:00:00,0,0,113,193,306
2012-07-07 16:00:00,0,0,102,192,294
2012-07-07 17:00:00,0,0,103,176,279
2012-07-07 18:00:00,0,0,83,194,277
2012-07-07 19:00:00,0,0,68,219,287
2012-07-07 20:00:00,0,0,79,197,276
2012-07-07 21:00:00,0,0,51,150,201
2012-07-07 22:00:00,0,0,56,164,220
2012-07-07 23:00:00,0,0,34,114,148
2012-07-08 00:00:00,0,0,22,125,147
2012-07-08 01:00:00,0,0,25,99,124
2012-07-08 02:00:00,0,0,11,59,70
2012-07-08 03:00:00,0,0,1,34,35
2012-07-08 04:00:00,0,0,2,11,13
2012-07-08 05:00:00,0,0,1,5,6
2012-07-08 06:00:00,0,0,5,16,21
2012-07-08 07:00:00,0,0,19,33,52
2012-07-08 08:00:00,0,0,35,95,130
2012-07-08 09:00:00,0,0,70,172,242
2012-07-08 10:00:00,0,0,85,234,319
2012-07-08 11:00:00,0,0,120,269,389
2012-07-08 12:00:00,0,0,105,271,376
2012-07-08 13:00:00,0,0,118,219,337
2012-07-08 14:00:00,0,0,77,235,312
2012-07-08 15:00:00,0,0,80,218,298
2012-07-08 16:00:00,0,0,65,226,291
2012-07-08 17:00:00,0,0,68,202,270
2012-07-08 18:00:00,0,0,54,199,253
2012-07-08 19:00:00,0,0,66,184,250
2012-07-08 20:00:00,0,0,79,206,285
2012-07-08 21:00:00,0,0,58,149,207
2012-07-08 22:00:00,0,0,12,110,122
2012-07-08 23:00:00,0,0,25,98,123
2012-07-09 00:00:00,0,1,6,33,39
2012-07-09 01:00:00,0,1,5,13,18
2012-07-09 02:00:00,0,1,1,4,5
2012-07-09 03:00:00,0,1,0,5,5
2012-07-09 04:00:00,0,1,1,1,2
2012-07-09 05:00:00,0,1,1,27,28
2012-07-09 06:00:00,0,1,6,86,92
2012-07-09 07:00:00,0,1,7,223,230
2012-07-09 08:00:00,0,1,26,429,455
2012-07-09 09:00:00,0,1,38,325,363
2012-07-09 10:00:00,0,1,58,117,175
2012-07-09 11:00:00,0,1,72,144,216
2012-07-09 12:00:00,0,1,61,205,266
2012-07-09 13:00:00,0,1,67,188,255
2012-07-09 14:00:00,0,1,58,184,242
2012-07-09 15:00:00,0,1,66,214,280
2012-07-09 16:00:00,0,1,88,325,413
2012-07-09 17:00:00,0,1,108,741,849
2012-07-09 18:00:00,0,1,82,790,872
2012-07-09 19:00:00,0,1,88,543,631
2012-07-09 20:00:00,0,1,69,378,447
2012-07-09 21:00:00,0,1,33,298,331
2012-07-09 22:00:00,0,1,35,189,224
2012-07-09 23:00:00,0,1,22,109,131
2012-07-10 00:00:00,0,1,16,53,69
2012-07-10 01:00:00,0,1,0,15,15
2012-07-10 02:00:00,0,1,1,15,16
2012-07-10 03:00:00,0,1,0,3,3
2012-07-10 04:00:00,0,1,0,4,4
2012-07-10 05:00:00,0,1,3,39,42
2012-07-10 06:00:00,0,1,4,183,187
2012-07-10 07:00:00,0,1,31,489,520
2012-07-10 08:00:00,0,1,34,615,649
2012-07-10 09:00:00,0,1,47,284,331
2012-07-10 10:00:00,0,1,56,134,190
2012-07-10 11:00:00,0,1,92,157,249
2012-07-10 12:00:00,0,1,69,203,272
2012-07-10 13:00:00,0,1,77,203,280
2012-07-10 14:00:00,0,1,71,171,242
2012-07-10 15:00:00,0,1,77,188,265
2012-07-10 16:00:00,0,1,89,346,435
2012-07-10 17:00:00,0,1,103,769,872
2012-07-10 18:00:00,0,1,70,749,819
2012-07-10 19:00:00,0,1,55,359,414
2012-07-10 20:00:00,0,1,9,75,84
2012-07-10 21:00:00,0,1,7,83,90
2012-07-10 22:00:00,0,1,14,125,139
2012-07-10 23:00:00,0,1,29,74,103
2012-07-11 00:00:00,0,1,6,38,44
2012-07-11 01:00:00,0,1,3,11,14
2012-07-11 02:00:00,0,1,0,5,5
2012-07-11 03:00:00,0,1,0,5,5
2012-07-11 04:00:00,0,1,1,6,7
2012-07-11 05:00:00,0,1,5,36,41
2012-07-11 06:00:00,0,1,17,168,185
2012-07-11 07:00:00,0,1,26,471,497
2012-07-11 08:00:00,0,1,30,644,674
2012-07-11 09:00:00,0,1,30,298,328
2012-07-11 10:00:00,0,1,47,148,195
2012-07-11 11:00:00,0,1,56,173,229
2012-07-11 12:00:00,0,1,69,223,292
2012-07-11 13:00:00,0,1,65,208,273
2012-07-11 14:00:00,0,1,66,175,241
2012-07-11 15:00:00,0,1,56,220,276
2012-07-11 16:00:00,0,1,53,358,411
2012-07-11 17:00:00,0,1,90,740,830
2012-07-11 18:00:00,0,1,79,735,814
2012-07-11 19:00:00,0,1,73,560,633
2012-07-11 20:00:00,0,1,73,410,483
2012-07-11 21:00:00,0,1,69,322,391
2012-07-11 22:00:00,0,1,41,203,244
2012-07-11 23:00:00,0,1,20,132,152
2012-07-12 00:00:00,0,1,1,55,56
2012-07-12 01:00:00,0,1,0,21,21
2012-07-12 02:00:00,0,1,0,9,9
2012-07-12 03:00:00,0,1,0,10,10
2012-07-12 04:00:00,0,1,0,5,5
2012-07-12 05:00:00,0,1,4,40,44
2012-07-12 06:00:00,0,1,7,171,178
2012-07-12 07:00:00,0,1,32,480,512
2012-07-12 08:00:00,0,1,49,653,702
2012-07-12 09:00:00,0,1,42,285,327
2012-07-12 10:00:00,0,1,69,145,214
2012-07-12 11:00:00,0,1,49,166,215
2012-07-12 12:00:00,0,1,71,221,292
2012-07-12 13:00:00,0,1,52,225,277
2012-07-12 14:00:00,0,1,42,167,209
2012-07-12 15:00:00,0,1,63,208,271
2012-07-12 16:00:00,0,1,69,370,439
2012-07-12 17:00:00,0,1,91,704,795
2012-07-12 18:00:00,0,1,86,739,825
2012-07-12 19:00:00,0,1,97,532,629
2012-07-12 20:00:00,0,1,75,439,514
2012-07-12 21:00:00,0,1,44,329,373
2012-07-12 22:00:00,0,1,56,262,318
2012-07-12 23:00:00,0,1,33,178,211
2012-07-13 00:00:00,0,1,19,76,95
2012-07-13 01:00:00,0,1,17,42,59
2012-07-13 02:00:00,0,1,2,15,17
2012-07-13 03:00:00,0,1,2,7,9
2012-07-13 04:00:00,0,1,0,11,11
2012-07-13 05:00:00,0,1,4,30,34
2012-07-13 06:00:00,0,1,7,120,127
2012-07-13 07:00:00,0,1,27,353,380
2012-07-13 08:00:00,0,1,53,660,713
2012-07-13 09:00:00,0,1,70,344,414
2012-07-13 10:00:00,0,1,78,190,268
2012-07-13 11:00:00,0,1,68,220,288
2012-07-13 12:00:00,0,1,125,254,379
2012-07-13 13:00:00,0,1,100,274,374
2012-07-13 14:00:00,0,1,120,249,369
2012-07-13 15:00:00,0,1,92,261,353
2012-07-13 16:00:00,0,1,111,381,492
2012-07-13 17:00:00,0,1,138,697,835
2012-07-13 18:00:00,0,1,108,523,631
2012-07-13 19:00:00,0,1,103,385,488
2012-07-13 20:00:00,0,1,95,294,389
2012-07-13 21:00:00,0,1,76,223,299
2012-07-13 22:00:00,0,1,59,204,263
2012-07-13 23:00:00,0,1,37,175,212
2012-07-14 00:00:00,0,0,35,156,191
2012-07-14 01:00:00,0,0,13,105,118
2012-07-14 02:00:00,0,0,10,91,101
2012-07-14 03:00:00,0,0,9,31,40
2012-07-14 04:00:00,0,0,3,6,9
2012-07-14 05:00:00,0,0,0,5,5
2012-07-14 06:00:00,0,0,6,29,35
2012-07-14 07:00:00,0,0,7,41,48
2012-07-14 08:00:00,0,0,33,118,151
2012-07-14 09:00:00,0,0,82,200,282
2012-07-14 10:00:00,0,0,123,278,401
2012-07-14 11:00:00,0,0,143,296,439
2012-07-14 12:00:00,0,0,181,318,499
2012-07-14 13:00:00,0,0,219,372,591
2012-07-14 14:00:00,0,0,269,363,632
2012-07-14 15:00:00,0,0,243,317,560
2012-07-14 16:00:00,0,0,226,340,566
2012-07-14 17:00:00,0,0,199,259,458
2012-07-14 18:00:00,0,0,108,243,351
2012-07-14 19:00:00,0,0,156,275,431
2012-07-14 20:00:00,0,0,101,255,356
2012-07-14 21:00:00,0,0,69,200,269
2012-07-14 22:00:00,0,0,65,160,225
2012-07-14 23:00:00,0,0,55,156,211
2012-07-15 00:00:00,0,0,40,147,187
2012-07-15 01:00:00,0,0,49,119,168
2012-07-15 02:00:00,0,0,29,86,115
2012-07-15 03:00:00,0,0,15,42,57
2012-07-15 04:00:00,0,0,8,11,19
2012-07-15 05:00:00,0,0,2,7,9
2012-07-15 06:00:00,0,0,6,9,15
2012-07-15 07:00:00,0,0,17,30,47
2012-07-15 08:00:00,0,0,37,96,133
2012-07-15 09:00:00,0,0,58,163,221
2012-07-15 10:00:00,0,0,141,241,382
2012-07-15 11:00:00,0,0,170,281,451
2012-07-15 12:00:00,0,0,153,336,489
2012-07-15 13:00:00,0,0,171,309,480
2012-07-15 14:00:00,0,0,162,314,476
2012-07-15 15:00:00,0,0,182,307,489
2012-07-15 16:00:00,0,0,152,343,495
2012-07-15 17:00:00,0,0,122,314,436
2012-07-15 18:00:00,0,0,84,228,312
2012-07-15 19:00:00,0,0,109,203,312
2012-07-15 20:00:00,0,0,95,199,294
2012-07-15 21:00:00,0,0,59,164,223
2012-07-15 22:00:00,0,0,34,96,130
2012-07-15 23:00:00,0,0,25,66,91
2012-07-16 00:00:00,0,1,11,32,43
2012-07-16 01:00:00,0,1,1,10,11
2012-07-16 02:00:00,0,1,4,11,15
2012-07-16 03:00:00,0,1,2,4,6
2012-07-16 04:00:00,0,1,1,11,12
2012-07-16 05:00:00,0,1,10,40,50
2012-07-16 06:00:00,0,1,8,132,140
2012-07-16 07:00:00,0,1,24,459,483
2012-07-16 08:00:00,0,1,48,619,667
2012-07-16 09:00:00,0,1,51,297,348
2012-07-16 10:00:00,0,1,69,117,186
2012-07-16 11:00:00,0,1,57,125,182
2012-07-16 12:00:00,0,1,79,158,237
2012-07-16 13:00:00,0,1,63,176,239
2012-07-16 14:00:00,0,1,53,159,212
2012-07-16 15:00:00,0,1,61,176,237
2012-07-16 16:00:00,0,1,77,309,386
2012-07-16 17:00:00,0,1,86,669,755
2012-07-16 18:00:00,0,1,97,697,794
2012-07-16 19:00:00,0,1,92,503,595
2012-07-16 20:00:00,0,1,66,388,454
2012-07-16 21:00:00,0,1,45,283,328
2012-07-16 22:00:00,0,1,56,228,284
2012-07-16 23:00:00,0,1,27,139,166
2012-07-17 00:00:00,0,1,10,43,53
2012-07-17 01:00:00,0,1,4,21,25
2012-07-17 02:00:00,0,1,1,6,7
2012-07-17 03:00:00,0,1,0,3,3
2012-07-17 04:00:00,0,1,0,7,7
2012-07-17 05:00:00,0,1,7,31,38
2012-07-17 06:00:00,0,1,16,197,213
2012-07-17 07:00:00,0,1,26,500,526
2012-07-17 08:00:00,0,1,43,618,661
2012-07-17 09:00:00,0,1,32,288,320
2012-07-17 10:00:00,0,1,37,122,159
2012-07-17 11:00:00,0,1,60,146,206
2012-07-17 12:00:00,0,1,80,174,254
2012-07-17 13:00:00,0,1,53,168,221
2012-07-17 14:00:00,0,1,54,160,214
2012-07-17 15:00:00,0,1,57,187,244
2012-07-17 16:00:00,0,1,64,317,381
2012-07-17 17:00:00,0,1,95,675,770
2012-07-17 18:00:00,0,1,60,712,772
2012-07-17 19:00:00,0,1,69,478,547
2012-07-17 20:00:00,0,1,52,375,427
2012-07-17 21:00:00,0,1,50,283,333
2012-07-17 22:00:00,0,1,29,215,244
2012-07-17 23:00:00,0,1,22,139,161
2012-07-18 00:00:00,0,1,8,45,53
2012-07-18 01:00:00,0,1,2,14,16
2012-07-18 02:00:00,0,1,3,5,8
2012-07-18 03:00:00,0,1,2,2,4
2012-07-18 04:00:00,0,1,0,6,6
2012-07-18 05:00:00,0,1,5,41,46
2012-07-18 06:00:00,0,1,10,152,162
2012-07-18 07:00:00,0,1,23,472,495
2012-07-18 08:00:00,0,1,55,624,679
2012-07-18 09:00:00,0,1,44,253,297
2012-07-18 10:00:00,0,1,39,99,138
2012-07-18 11:00:00,0,1,47,136,183
2012-07-18 12:00:00,0,1,36,166,202
2012-07-18 13:00:00,0,1,49,154,203
2012-07-18 14:00:00,0,1,54,116,170
2012-07-18 15:00:00,0,1,42,152,194
2012-07-18 16:00:00,0,1,34,190,224
2012-07-18 17:00:00,0,1,35,335,370
2012-07-18 18:00:00,0,1,63,580,643
2012-07-18 19:00:00,0,1,78,438,516
2012-07-18 20:00:00,0,1,56,310,366
2012-07-18 21:00:00,0,1,53,266,319
2012-07-18 22:00:00,0,1,42,246,288
2012-07-18 23:00:00,0,1,19,112,131
2012-07-19 00:00:00,0,1,16,50,66
2012-07-19 01:00:00,0,1,6,19,25
2012-07-19 02:00:00,0,1,0,7,7
2012-07-19 03:00:00,0,1,1,4,5
2012-07-19 04:00:00,0,1,0,8,8
2012-07-19 05:00:00,0,1,5,35,40
2012-07-19 06:00:00,0,1,8,144,152
2012-07-19 07:00:00,0,1,23,450,473
2012-07-19 08:00:00,0,1,32,625,657
2012-07-19 09:00:00,0,1,36,282,318
2012-07-19 10:00:00,0,1,41,157,198
2012-07-19 11:00:00,0,1,54,162,216
2012-07-19 12:00:00,0,1,59,215,274
2012-07-19 13:00:00,0,1,74,180,254
2012-07-19 14:00:00,0,1,46,151,197
2012-07-19 15:00:00,0,1,66,226,292
2012-07-19 16:00:00,0,1,70,288,358
2012-07-19 17:00:00,0,1,93,678,771
2012-07-19 18:00:00,0,1,93,684,777
2012-07-19 19:00:00,0,1,53,480,533
2012-07-19 20:00:00,0,1,65,440,505
2012-07-19 21:00:00,0,1,38,294,332
2012-07-19 22:00:00,0,1,6,62,68
2012-07-19 23:00:00,0,1,3,62,65
2012-08-01 00:00:00,0,1,3,44,47
2012-08-01 01:00:00,0,1,5,28,33
2012-08-01 02:00:00,0,1,0,13,13
2012-08-01 03:00:00,0,1,0,7,7
2012-08-01 04:00:00,0,1,1,3,4
2012-08-01 05:00:00,0,1,3,46,49
2012-08-01 06:00:00,0,1,6,179,185
2012-08-01 07:00:00,0,1,19,468,487
2012-08-01 08:00:00,0,1,32,649,681
2012-08-01 09:00:00,0,1,34,316,350
2012-08-01 10:00:00,0,1,61,175,236
2012-08-01 11:00:00,0,1,54,180,234
2012-08-01 12:00:00,0,1,75,209,284
2012-08-01 13:00:00,0,1,59,221,280
2012-08-01 14:00:00,0,1,88,175,263
2012-08-01 15:00:00,0,1,89,206,295
2012-08-01 16:00:00,0,1,93,386,479
2012-08-01 17:00:00,0,1,103,734,837
2012-08-01 18:00:00,0,1,105,786,891
2012-08-01 19:00:00,0,1,88,564,652
2012-08-01 20:00:00,0,1,65,448,513
2012-08-01 21:00:00,0,1,36,284,320
2012-08-01 22:00:00,0,1,37,251,288
2012-08-01 23:00:00,0,1,18,134,152
2012-08-02 00:00:00,0,1,8,55,63
2012-08-02 01:00:00,0,1,6,36,42
2012-08-02 02:00:00,0,1,3,8,11
2012-08-02 03:00:00,0,1,0,6,6
2012-08-02 04:00:00,0,1,0,9,9
2012-08-02 05:00:00,0,1,4,37,41
2012-08-02 06:00:00,0,1,6,177,183
2012-08-02 07:00:00,0,1,21,452,473
2012-08-02 08:00:00,0,1,21,718,739
2012-08-02 09:00:00,0,1,31,312,343
2012-08-02 10:00:00,0,1,51,130,181
2012-08-02 11:00:00,0,1,59,167,226
2012-08-02 12:00:00,0,1,56,230,286
2012-08-02 13:00:00,0,1,98,212,310
2012-08-02 14:00:00,0,1,54,171,225
2012-08-02 15:00:00,0,1,68,202,270
2012-08-02 16:00:00,0,1,71,335,406
2012-08-02 17:00:00,0,1,90,775,865
2012-08-02 18:00:00,0,1,86,681,767
2012-08-02 19:00:00,0,1,98,509,607
2012-08-02 20:00:00,0,1,51,376,427
2012-08-02 21:00:00,0,1,41,301,342
2012-08-02 22:00:00,0,1,35,227,262
2012-08-02 23:00:00,0,1,25,152,177
2012-08-03 00:00:00,0,1,15,56,71
2012-08-03 01:00:00,0,1,11,32,43
2012-08-03 02:00:00,0,1,0,14,14
2012-08-03 03:00:00,0,1,1,5,6
2012-08-03 04:00:00,0,1,1,11,12
2012-08-03 05:00:00,0,1,2,35,37
2012-08-03 06:00:00,0,1,5,158,163
2012-08-03 07:00:00,0,1,25,396,421
2012-08-03 08:00:00,0,1,32,636,668
2012-08-03 09:00:00,0,1,69,327,396
2012-08-03 10:00:00,0,1,82,167,249
2012-08-03 11:00:00,0,1,77,186,263
2012-08-03 12:00:00,0,1,95,243,338
2012-08-03 13:00:00,0,1,98,247,345
2012-08-03 14:00:00,0,1,102,229,331
2012-08-03 15:00:00,0,1,112,268,380
2012-08-03 16:00:00,0,1,112,380,492
2012-08-03 17:00:00,0,1,95,646,741
2012-08-03 18:00:00,0,1,98,573,671
2012-08-03 19:00:00,0,1,81,388,469
2012-08-03 20:00:00,0,1,89,300,389
2012-08-03 21:00:00,0,1,54,224,278
2012-08-03 22:00:00,0,1,46,156,202
2012-08-03 23:00:00,0,1,26,170,196
2012-08-04 00:00:00,0,0,24,137,161
2012-08-04 01:00:00,0,0,23,99,122
2012-08-04 02:00:00,0,0,20,64,84
2012-08-04 03:00:00,0,0,11,19,30
2012-08-04 04:00:00,0,0,2,11,13
2012-08-04 05:00:00,0,0,1,16,17
2012-08-04 06:00:00,0,0,12,37,49
2012-08-04 07:00:00,0,0,18,49,67
2012-08-04 08:00:00,0,0,49,132,181
2012-08-04 09:00:00,0,0,61,217,278
2012-08-04 10:00:00,0,0,108,288,396
2012-08-04 11:00:00,0,0,155,315,470
2012-08-04 12:00:00,0,0,222,325,547
2012-08-04 13:00:00,0,0,195,332,527
2012-08-04 14:00:00,0,0,183,289,472
2012-08-04 15:00:00,0,0,205,284,489
2012-08-04 16:00:00,0,0,197,253,450
2012-08-04 17:00:00,0,0,179,313,492
2012-08-04 18:00:00,0,0,169,321,490
2012-08-04 19:00:00,0,0,133,264,397
2012-08-04 20:00:00,0,0,117,195,312
2012-08-04 21:00:00,0,0,96,193,289
2012-08-04 22:00:00,0,0,104,165,269
2012-08-04 23:00:00,0,0,61,161,222
2012-08-05 00:00:00,0,0,32,121,153
2012-08-05 01:00:00,0,0,8,79,87
2012-08-05 02:00:00,0,0,5,68,73
2012-08-05 03:00:00,0,0,9,32,41
2012-08-05 04:00:00,0,0,3,11,14
2012-08-05 05:00:00,0,0,1,18,19
2012-08-05 06:00:00,0,0,7,12,19
2012-08-05 07:00:00,0,0,18,50,68
2012-08-05 08:00:00,0,0,27,81,108
2012-08-05 09:00:00,0,0,61,168,229
2012-08-05 10:00:00,0,0,111,253,364
2012-08-05 11:00:00,0,0,155,282,437
2012-08-05 12:00:00,0,0,161,330,491
2012-08-05 13:00:00,0,0,208,315,523
2012-08-05 14:00:00,0,0,161,365,526
2012-08-05 15:00:00,0,0,164,286,450
2012-08-05 16:00:00,0,0,143,278,421
2012-08-05 17:00:00,0,0,122,260,382
2012-08-05 18:00:00,0,0,75,154,229
2012-08-05 19:00:00,0,0,46,139,185
2012-08-05 20:00:00,0,0,53,140,193
2012-08-05 21:00:00,0,0,51,157,208
2012-08-05 22:00:00,0,0,57,100,157
2012-08-05 23:00:00,0,0,29,58,87
2012-08-06 00:00:00,0,1,9,24,33
2012-08-06 01:00:00,0,1,1,10,11
2012-08-06 02:00:00,0,1,0,5,5
2012-08-06 03:00:00,0,1,0,5,5
2012-08-06 04:00:00,0,1,3,8,11
2012-08-06 05:00:00,0,1,2,23,25
2012-08-06 06:00:00,0,1,4,137,141
2012-08-06 07:00:00,0,1,14,393,407
2012-08-06 08:00:00,0,1,27,578,605
2012-08-06 09:00:00,0,1,28,248,276
2012-08-06 10:00:00,0,1,54,159,213
2012-08-06 11:00:00,0,1,108,152,260
2012-08-06 12:00:00,0,1,72,213,285
2012-08-06 13:00:00,0,1,85,204,289
2012-08-06 14:00:00,0,1,99,188,287
2012-08-06 15:00:00,0,1,91,183,274
2012-08-06 16:00:00,0,1,88,363,451
2012-08-06 17:00:00,0,1,112,746,858
2012-08-06 18:00:00,0,1,100,743,843
2012-08-06 19:00:00,0,1,109,531,640
2012-08-06 20:00:00,0,1,89,368,457
2012-08-06 21:00:00,0,1,72,245,317
2012-08-06 22:00:00,0,1,50,157,207
2012-08-06 23:00:00,0,1,16,97,113
2012-08-07 00:00:00,0,1,15,32,47
2012-08-07 01:00:00,0,1,2,16,18
2012-08-07 02:00:00,0,1,6,7,13
2012-08-07 03:00:00,0,1,0,6,6
2012-08-07 04:00:00,0,1,2,7,9
2012-08-07 05:00:00,0,1,3,33,36
2012-08-07 06:00:00,0,1,3,176,179
2012-08-07 07:00:00,0,1,21,481,502
2012-08-07 08:00:00,0,1,41,664,705
2012-08-07 09:00:00,0,1,44,283,327
2012-08-07 10:00:00,0,1,89,161,250
2012-08-07 11:00:00,0,1,84,130,214
2012-08-07 12:00:00,0,1,86,197,283
2012-08-07 13:00:00,0,1,68,185,253
2012-08-07 14:00:00,0,1,76,185,261
2012-08-07 15:00:00,0,1,100,206,306
2012-08-07 16:00:00,0,1,101,344,445
2012-08-07 17:00:00,0,1,125,743,868
2012-08-07 18:00:00,0,1,103,711,814
2012-08-07 19:00:00,0,1,104,506,610
2012-08-07 20:00:00,0,1,74,374,448
2012-08-07 21:00:00,0,1,70,247,317
2012-08-07 22:00:00,0,1,43,181,224
2012-08-07 23:00:00,0,1,18,120,138
2012-08-08 00:00:00,0,1,12,46,58
2012-08-08 01:00:00,0,1,3,20,23
2012-08-08 02:00:00,0,1,1,5,6
2012-08-08 03:00:00,0,1,1,6,7
2012-08-08 04:00:00,0,1,1,6,7
2012-08-08 05:00:00,0,1,3,40,43
2012-08-08 06:00:00,0,1,4,169,173
2012-08-08 07:00:00,0,1,24,458,482
2012-08-08 08:00:00,0,1,48,689,737
2012-08-08 09:00:00,0,1,33,308,341
2012-08-08 10:00:00,0,1,63,151,214
2012-08-08 11:00:00,0,1,80,159,239
2012-08-08 12:00:00,0,1,63,217,280
2012-08-08 13:00:00,0,1,101,212,313
2012-08-08 14:00:00,0,1,63,173,236
2012-08-08 15:00:00,0,1,110,168,278
2012-08-08 16:00:00,0,1,113,328,441
2012-08-08 17:00:00,0,1,107,751,858
2012-08-08 18:00:00,0,1,117,745,862
2012-08-08 19:00:00,0,1,119,567,686
2012-08-08 20:00:00,0,1,76,424,500
2012-08-08 21:00:00,0,1,70,311,381
2012-08-08 22:00:00,0,1,35,198,233
2012-08-08 23:00:00,0,1,16,120,136
2012-08-09 00:00:00,0,1,16,51,67
2012-08-09 01:00:00,0,1,5,23,28
2012-08-09 02:00:00,0,1,2,12,14
2012-08-09 03:00:00,0,1,1,5,6
2012-08-09 04:00:00,0,1,0,10,10
2012-08-09 05:00:00,0,1,4,37,41
2012-08-09 06:00:00,0,1,5,162,167
2012-08-09 07:00:00,0,1,24,451,475
2012-08-09 08:00:00,0,1,28,670,698
2012-08-09 09:00:00,0,1,54,299,353
2012-08-09 10:00:00,0,1,72,133,205
2012-08-09 11:00:00,0,1,94,166,260
2012-08-09 12:00:00,0,1,85,192,277
2012-08-09 13:00:00,0,1,80,201,281
2012-08-09 14:00:00,0,1,86,161,247
2012-08-09 15:00:00,0,1,63,204,267
2012-08-09 16:00:00,0,1,97,320,417
2012-08-09 17:00:00,0,1,111,699,810
2012-08-09 18:00:00,0,1,78,733,811
2012-08-09 19:00:00,0,1,90,533,623
2012-08-09 20:00:00,0,1,91,387,478
2012-08-09 21:00:00,0,1,50,286,336
2012-08-09 22:00:00,0,1,41,218,259
2012-08-09 23:00:00,0,1,19,137,156
2012-08-10 00:00:00,0,1,17,68,85
2012-08-10 01:00:00,0,1,6,35,41
2012-08-10 02:00:00,0,1,6,14,20
2012-08-10 03:00:00,0,1,3,6,9
2012-08-10 04:00:00,0,1,0,7,7
2012-08-10 05:00:00,0,1,4,29,33
2012-08-10 06:00:00,0,1,3,41,44
2012-08-10 07:00:00,0,1,5,128,133
2012-08-10 08:00:00,0,1,7,112,119
2012-08-10 09:00:00,0,1,21,199,220
2012-08-10 10:00:00,0,1,27,166,193
2012-08-10 11:00:00,0,1,73,178,251
2012-08-10 12:00:00,0,1,75,240,315
2012-08-10 13:00:00,0,1,66,224,290
2012-08-10 14:00:00,0,1,71,236,307
2012-08-10 15:00:00,0,1,100,224,324
2012-08-10 16:00:00,0,1,96,371,467
2012-08-10 17:00:00,0,1,111,619,730
2012-08-10 18:00:00,0,1,88,552,640
2012-08-10 19:00:00,0,1,98,394,492
2012-08-10 20:00:00,0,1,55,315,370
2012-08-10 21:00:00,0,1,50,236,286
2012-08-10 22:00:00,0,1,50,168,218
2012-08-10 23:00:00,0,1,33,159,192
2012-08-11 00:00:00,0,0,38,142,180
2012-08-11 01:00:00,0,0,32,84,116
2012-08-11 02:00:00,0,0,19,66,85
2012-08-11 03:00:00,0,0,2,19,21
2012-08-11 04:00:00,0,0,3,7,10
2012-08-11 05:00:00,0,0,2,9,11
2012-08-11 06:00:00,0,0,5,18,23
2012-08-11 07:00:00,0,0,8,54,62
2012-08-11 08:00:00,0,0,30,132,162
2012-08-11 09:00:00,0,0,54,217,271
2012-08-11 10:00:00,0,0,125,282,407
2012-08-11 11:00:00,0,0,203,296,499
2012-08-11 12:00:00,0,0,214,332,546
2012-08-11 13:00:00,0,0,228,341,569
2012-08-11 14:00:00,0,0,248,290,538
2012-08-11 15:00:00,0,0,246,316,562
2012-08-11 16:00:00,0,0,227,304,531
2012-08-11 17:00:00,0,0,220,292,512
2012-08-11 18:00:00,0,0,107,193,300
2012-08-11 19:00:00,0,0,97,178,275
2012-08-11 20:00:00,0,0,31,129,160
2012-08-11 21:00:00,0,0,26,102,128
2012-08-11 22:00:00,0,0,40,128,168
2012-08-11 23:00:00,0,0,42,121,163
2012-08-12 00:00:00,0,0,24,96,120
2012-08-12 01:00:00,0,0,21,92,113
2012-08-12 02:00:00,0,0,19,67,86
2012-08-12 03:00:00,0,0,11,37,48
2012-08-12 04:00:00,0,0,2,8,10
2012-08-12 05:00:00,0,0,1,9,10
2012-08-12 06:00:00,0,0,2,14,16
2012-08-12 07:00:00,0,0,9,30,39
2012-08-12 08:00:00,0,0,35,84,119
2012-08-12 09:00:00,0,0,64,153,217
2012-08-12 10:00:00,0,0,88,240,328
2012-08-12 11:00:00,0,0,167,282,449
2012-08-12 12:00:00,0,0,163,342,505
2012-08-12 13:00:00,0,0,178,365,543
2012-08-12 14:00:00,0,0,213,366,579
2012-08-12 15:00:00,0,0,235,342,577
2012-08-12 16:00:00,0,0,213,300,513
2012-08-12 17:00:00,0,0,186,319,505
2012-08-12 18:00:00,0,0,164,327,491
2012-08-12 19:00:00,0,0,148,317,465
2012-08-12 20:00:00,0,0,96,204,300
2012-08-12 21:00:00,0,0,78,142,220
2012-08-12 22:00:00,0,0,40,141,181
2012-08-12 23:00:00,0,0,25,85,110
2012-08-13 00:00:00,0,1,14,33,47
2012-08-13 01:00:00,0,1,3,11,14
2012-08-13 02:00:00,0,1,1,8,9
2012-08-13 03:00:00,0,1,1,5,6
2012-08-13 04:00:00,0,1,0,11,11
2012-08-13 05:00:00,0,1,3,33,36
2012-08-13 06:00:00,0,1,4,155,159
2012-08-13 07:00:00,0,1,11,425,436
2012-08-13 08:00:00,0,1,25,648,673
2012-08-13 09:00:00,0,1,40,265,305
2012-08-13 10:00:00,0,1,88,111,199
2012-08-13 11:00:00,0,1,94,151,245
2012-08-13 12:00:00,0,1,96,180,276
2012-08-13 13:00:00,0,1,79,175,254
2012-08-13 14:00:00,0,1,85,163,248
2012-08-13 15:00:00,0,1,80,194,274
2012-08-13 16:00:00,0,1,116,348,464
2012-08-13 17:00:00,0,1,102,716,818
2012-08-13 18:00:00,0,1,103,709,812
2012-08-13 19:00:00,0,1,88,467,555
2012-08-13 20:00:00,0,1,58,374,432
2012-08-13 21:00:00,0,1,44,246,290
2012-08-13 22:00:00,0,1,44,148,192
2012-08-13 23:00:00,0,1,28,100,128
2012-08-14 00:00:00,0,1,12,48,60
2012-08-14 01:00:00,0,1,8,19,27
2012-08-14 02:00:00,0,1,2,9,11
2012-08-14 03:00:00,0,1,0,3,3
2012-08-14 04:00:00,0,1,0,5,5
2012-08-14 05:00:00,0,1,1,35,36
2012-08-14 06:00:00,0,1,1,63,64
2012-08-14 07:00:00,0,1,1,178,179
2012-08-14 08:00:00,0,1,27,591,618
2012-08-14 09:00:00,0,1,48,354,402
2012-08-14 10:00:00,0,1,53,155,208
2012-08-14 11:00:00,0,1,69,127,196
2012-08-14 12:00:00,0,1,93,207,300
2012-08-14 13:00:00,0,1,83,203,286
2012-08-14 14:00:00,0,1,80,175,255
2012-08-14 15:00:00,0,1,84,199,283
2012-08-14 16:00:00,0,1,95,363,458
2012-08-14 17:00:00,0,1,78,734,812
2012-08-14 18:00:00,0,1,97,757,854
2012-08-14 19:00:00,0,1,94,533,627
2012-08-14 20:00:00,0,1,65,371,436
2012-08-14 21:00:00,0,1,56,252,308
2012-08-14 22:00:00,0,1,28,161,189
2012-08-14 23:00:00,0,1,53,114,167
2012-08-15 00:00:00,0,1,8,52,60
2012-08-15 01:00:00,0,1,6,31,37
2012-08-15 02:00:00,0,1,1,7,8
2012-08-15 03:00:00,0,1,1,10,11
2012-08-15 04:00:00,0,1,0,4,4
2012-08-15 05:00:00,0,1,4,35,39
2012-08-15 06:00:00,0,1,12,160,172
2012-08-15 07:00:00,0,1,25,467,492
2012-08-15 08:00:00,0,1,40,642,682
2012-08-15 09:00:00,0,1,57,310,367
2012-08-15 10:00:00,0,1,70,163,233
2012-08-15 11:00:00,0,1,80,155,235
2012-08-15 12:00:00,0,1,77,230,307
2012-08-15 13:00:00,0,1,88,206,294
2012-08-15 14:00:00,0,1,94,161,255
2012-08-15 15:00:00,0,1,70,196,266
2012-08-15 16:00:00,0,1,91,340,431
2012-08-15 17:00:00,0,1,102,749,851
2012-08-15 18:00:00,0,1,80,768,848
2012-08-15 19:00:00,0,1,124,525,649
2012-08-15 20:00:00,0,1,72,355,427
2012-08-15 21:00:00,0,1,49,266,315
2012-08-15 22:00:00,0,1,29,197,226
2012-08-15 23:00:00,0,1,18,120,138
2012-08-16 00:00:00,0,1,13,63,76
2012-08-16 01:00:00,0,1,3,18,21
2012-08-16 02:00:00,0,1,0,15,15
2012-08-16 03:00:00,0,1,0,4,4
2012-08-16 04:00:00,0,1,2,3,5
2012-08-16 05:00:00,0,1,7,30,37
2012-08-16 06:00:00,0,1,3,162,165
2012-08-16 07:00:00,0,1,16,448,464
2012-08-16 08:00:00,0,1,33,649,682
2012-08-16 09:00:00,0,1,41,296,337
2012-08-16 10:00:00,0,1,78,121,199
2012-08-16 11:00:00,0,1,83,191,274
2012-08-16 12:00:00,0,1,96,247,343
2012-08-16 13:00:00,0,1,81,219,300
2012-08-16 14:00:00,0,1,72,176,248
2012-08-16 15:00:00,0,1,63,197,260
2012-08-16 16:00:00,0,1,79,340,419
2012-08-16 17:00:00,0,1,130,767,897
2012-08-16 18:00:00,0,1,109,723,832
2012-08-16 19:00:00,0,1,119,558,677
2012-08-16 20:00:00,0,1,100,414,514
2012-08-16 21:00:00,0,1,83,273,356
2012-08-16 22:00:00,0,1,69,185,254
2012-08-16 23:00:00,0,1,58,168,226
2012-08-17 00:00:00,0,1,21,67,88
2012-08-17 01:00:00,0,1,16,38,54
2012-08-17 02:00:00,0,1,4,15,19
2012-08-17 03:00:00,0,1,0,6,6
2012-08-17 04:00:00,0,1,0,9,9
2012-08-17 05:00:00,0,1,2,34,36
2012-08-17 06:00:00,0,1,6,151,157
2012-08-17 07:00:00,0,1,11,368,379
2012-08-17 08:00:00,0,1,43,625,668
2012-08-17 09:00:00,0,1,58,320,378
2012-08-17 10:00:00,0,1,82,149,231
2012-08-17 11:00:00,0,1,98,205,303
2012-08-17 12:00:00,0,1,110,255,365
2012-08-17 13:00:00,0,1,103,254,357
2012-08-17 14:00:00,0,1,128,200,328
2012-08-17 15:00:00,0,1,127,256,383
2012-08-17 16:00:00,0,1,116,372,488
2012-08-17 17:00:00,0,1,144,647,791
2012-08-17 18:00:00,0,1,108,561,669
2012-08-17 19:00:00,0,1,88,403,491
2012-08-17 20:00:00,0,1,97,262,359
2012-08-17 21:00:00,0,1,57,198,255
2012-08-17 22:00:00,0,1,43,170,213
2012-08-17 23:00:00,0,1,21,100,121
2012-08-18 00:00:00,0,0,6,99,105
2012-08-18 01:00:00,0,0,14,78,92
2012-08-18 02:00:00,0,0,4,39,43
2012-08-18 03:00:00,0,0,7,23,30
2012-08-18 04:00:00,0,0,5,8,13
2012-08-18 05:00:00,0,0,2,7,9
2012-08-18 06:00:00,0,0,4,23,27
2012-08-18 07:00:00,0,0,12,52,64
2012-08-18 08:00:00,0,0,28,161,189
2012-08-18 09:00:00,0,0,81,211,292
2012-08-18 10:00:00,0,0,166,314,480
2012-08-18 11:00:00,0,0,180,356,536
2012-08-18 12:00:00,0,0,266,388,654
2012-08-18 13:00:00,0,0,289,355,644
2012-08-18 14:00:00,0,0,242,356,598
2012-08-18 15:00:00,0,0,250,346,596
2012-08-18 16:00:00,0,0,287,354,641
2012-08-18 17:00:00,0,0,256,379,635
2012-08-18 18:00:00,0,0,225,329,554
2012-08-18 19:00:00,0,0,164,324,488
2012-08-18 20:00:00,0,0,99,242,341
2012-08-18 21:00:00,0,0,90,248,338
2012-08-18 22:00:00,0,0,90,171,261
2012-08-18 23:00:00,0,0,60,175,235
2012-08-19 00:00:00,0,0,44,143,187
2012-08-19 01:00:00,0,0,29,102,131
2012-08-19 02:00:00,0,0,16,103,119
2012-08-19 03:00:00,0,0,21,34,55
2012-08-19 04:00:00,0,0,4,22,26
2012-08-19 05:00:00,0,0,3,8,11
2012-08-19 06:00:00,0,0,5,15,20
2012-08-19 07:00:00,0,0,12,29,41
2012-08-19 08:00:00,0,0,34,90,124
2012-08-19 09:00:00,0,0,86,184,270
2012-08-19 10:00:00,0,0,138,287,425
2012-08-19 11:00:00,0,0,83,189,272
2012-08-19 12:00:00,0,0,112,186,298
2012-08-19 13:00:00,0,0,50,112,162
2012-08-19 14:00:00,0,0,41,108,149
2012-08-19 15:00:00,0,0,89,187,276
2012-08-19 16:00:00,0,0,97,259,356
2012-08-19 17:00:00,0,0,76,267,343
2012-08-19 18:00:00,0,0,86,291,377
2012-08-19 19:00:00,0,0,72,269,341
2012-08-19 20:00:00,0,0,61,213,274
2012-08-19 21:00:00,0,0,36,154,190
2012-08-19 22:00:00,0,0,6,50,56
2012-08-19 23:00:00,0,0,7,39,46
2012-09-01 00:00:00,0,0,22,146,168
2012-09-01 01:00:00,0,0,11,68,79
2012-09-01 02:00:00,0,0,8,61,69
2012-09-01 03:00:00,0,0,6,29,35
2012-09-01 04:00:00,0,0,3,9,12
2012-09-01 05:00:00,0,0,2,20,22
2012-09-01 06:00:00,0,0,13,23,36
2012-09-01 07:00:00,0,0,8,58,66
2012-09-01 08:00:00,0,0,28,134,162
2012-09-01 09:00:00,0,0,62,175,237
2012-09-01 10:00:00,0,0,128,289,417
2012-09-01 11:00:00,0,0,219,273,492
2012-09-01 12:00:00,0,0,187,284,471
2012-09-01 13:00:00,0,0,237,267,504
2012-09-01 14:00:00,0,0,240,274,514
2012-09-01 15:00:00,0,0,257,306,563
2012-09-01 16:00:00,0,0,209,253,462
2012-09-01 17:00:00,0,0,205,258,463
2012-09-01 18:00:00,0,0,184,258,442
2012-09-01 19:00:00,0,0,157,235,392
2012-09-01 20:00:00,0,0,67,140,207
2012-09-01 21:00:00,0,0,21,83,104
2012-09-01 22:00:00,0,0,21,57,78
2012-09-01 23:00:00,0,0,57,88,145
2012-09-02 00:00:00,0,0,27,72,99
2012-09-02 01:00:00,0,0,15,58,73
2012-09-02 02:00:00,0,0,28,56,84
2012-09-02 03:00:00,0,0,9,33,42
2012-09-02 04:00:00,0,0,7,15,22
2012-09-02 05:00:00,0,0,2,10,12
2012-09-02 06:00:00,0,0,2,13,15
2012-09-02 07:00:00,0,0,13,29,42
2012-09-02 08:00:00,0,0,30,99,129
2012-09-02 09:00:00,0,0,88,144,232
2012-09-02 10:00:00,0,0,158,230,388
2012-09-02 11:00:00,0,0,226,263,489
2012-09-02 12:00:00,0,0,248,297,545
2012-09-02 13:00:00,0,0,263,230,493
2012-09-02 14:00:00,0,0,249,208,457
2012-09-02 15:00:00,0,0,179,176,355
2012-09-02 16:00:00,0,0,222,252,474
2012-09-02 17:00:00,0,0,219,284,503
2012-09-02 18:00:00,0,0,227,273,500
2012-09-02 19:00:00,0,0,140,152,292
2012-09-02 20:00:00,0,0,63,41,104
2012-09-02 21:00:00,0,0,79,92,171
2012-09-02 22:00:00,0,0,66,100,166
2012-09-02 23:00:00,0,0,53,70,123
2012-09-03 00:00:00,1,0,42,62,104
2012-09-03 01:00:00,1,0,18,37,55
2012-09-03 02:00:00,1,0,10,30,40
2012-09-03 03:00:00,1,0,6,22,28
2012-09-03 04:00:00,1,0,6,5,11
2012-09-03 05:00:00,1,0,1,3,4
2012-09-03 06:00:00,1,0,3,12,15
2012-09-03 07:00:00,1,0,6,37,43
2012-09-03 08:00:00,1,0,36,91,127
2012-09-03 09:00:00,1,0,71,158,229
2012-09-03 10:00:00,1,0,135,224,359
2012-09-03 11:00:00,1,0,187,272,459
2012-09-03 12:00:00,1,0,191,352,543
2012-09-03 13:00:00,1,0,209,357,566
2012-09-03 14:00:00,1,0,163,349,512
2012-09-03 15:00:00,1,0,168,281,449
2012-09-03 16:00:00,1,0,165,335,500
2012-09-03 17:00:00,1,0,181,317,498
2012-09-03 18:00:00,1,0,145,337,482
2012-09-03 19:00:00,1,0,73,301,374
2012-09-03 20:00:00,1,0,78,183,261
2012-09-03 21:00:00,1,0,42,142,184
2012-09-03 22:00:00,1,0,17,104,121
2012-09-03 23:00:00,1,0,12,58,70
2012-09-04 00:00:00,0,1,10,19,29
2012-09-04 01:00:00,0,1,15,9,24
2012-09-04 02:00:00,0,1,1,4,5
2012-09-04 03:00:00,0,1,1,9,10
2012-09-04 04:00:00,0,1,0,8,8
2012-09-04 05:00:00,0,1,1,37,38
2012-09-04 06:00:00,0,1,7,165,172
2012-09-04 07:00:00,0,1,13,480,493
2012-09-04 08:00:00,0,1,15,617,632
2012-09-04 09:00:00,0,1,30,293,323
2012-09-04 10:00:00,0,1,42,130,172
2012-09-04 11:00:00,0,1,39,159,198
2012-09-04 12:00:00,0,1,54,233,287
2012-09-04 13:00:00,0,1,72,203,275
2012-09-04 14:00:00,0,1,72,202,274
2012-09-04 15:00:00,0,1,68,224,292
2012-09-04 16:00:00,0,1,61,397,458
2012-09-04 17:00:00,0,1,110,746,856
2012-09-04 18:00:00,0,1,94,745,839
2012-09-04 19:00:00,0,1,50,502,552
2012-09-04 20:00:00,0,1,47,338,385
2012-09-04 21:00:00,0,1,28,240,268
2012-09-04 22:00:00,0,1,25,154,179
2012-09-04 23:00:00,0,1,12,83,95
2012-09-05 00:00:00,0,1,10,27,37
2012-09-05 01:00:00,0,1,2,11,13
2012-09-05 02:00:00,0,1,0,9,9
2012-09-05 03:00:00,0,1,0,4,4
2012-09-05 04:00:00,0,1,2,3,5
2012-09-05 05:00:00,0,1,1,39,40
2012-09-05 06:00:00,0,1,7,203,210
2012-09-05 07:00:00,0,1,11,489,500
2012-09-05 08:00:00,0,1,33,692,725
2012-09-05 09:00:00,0,1,27,263,290
2012-09-05 10:00:00,0,1,54,181,235
2012-09-05 11:00:00,0,1,61,156,217
2012-09-05 12:00:00,0,1,49,217,266
2012-09-05 13:00:00,0,1,50,184,234
2012-09-05 14:00:00,0,1,34,177,211
2012-09-05 15:00:00,0,1,41,204,245
2012-09-05 16:00:00,0,1,86,344,430
2012-09-05 17:00:00,0,1,83,780,863
2012-09-05 18:00:00,0,1,82,757,839
2012-09-05 19:00:00,0,1,64,598,662
2012-09-05 20:00:00,0,1,55,357,412
2012-09-05 21:00:00,0,1,18,278,296
2012-09-05 22:00:00,0,1,38,181,219
2012-09-05 23:00:00,0,1,24,126,150
2012-09-06 00:00:00,0,1,30,35,65
2012-09-06 01:00:00,0,1,2,16,18
2012-09-06 02:00:00,0,1,1,7,8
2012-09-06 03:00:00,0,1,0,9,9
2012-09-06 04:00:00,0,1,0,8,8
2012-09-06 05:00:00,0,1,3,35,38
2012-09-06 06:00:00,0,1,11,189,200
2012-09-06 07:00:00,0,1,21,461,482
2012-09-06 08:00:00,0,1,24,622,646
2012-09-06 09:00:00,0,1,8,115,123
2012-09-06 10:00:00,0,1,9,40,49
2012-09-06 11:00:00,0,1,10,52,62
2012-09-06 12:00:00,0,1,11,126,137
2012-09-06 13:00:00,0,1,39,152,191
2012-09-06 14:00:00,0,1,38,178,216
2012-09-06 15:00:00,0,1,42,228,270
2012-09-06 16:00:00,0,1,42,374,416
2012-09-06 17:00:00,0,1,67,741,808
2012-09-06 18:00:00,0,1,74,761,835
2012-09-06 19:00:00,0,1,54,504,558
2012-09-06 20:00:00,0,1,50,356,406
2012-09-06 21:00:00,0,1,32,240,272
2012-09-06 22:00:00,0,1,24,193,217
2012-09-06 23:00:00,0,1,19,150,169
2012-09-07 00:00:00,0,1,17,79,96
2012-09-07 01:00:00,0,1,10,19,29
2012-09-07 02:00:00,0,1,1,10,11
2012-09-07 03:00:00,0,1,0,9,9
2012-09-07 04:00:00,0,1,1,7,8
2012-09-07 05:00:00,0,1,1,39,40
2012-09-07 06:00:00,0,1,5,135,140
2012-09-07 07:00:00,0,1,21,465,486
2012-09-07 08:00:00,0,1,29,690,719
2012-09-07 09:00:00,0,1,33,311,344
2012-09-07 10:00:00,0,1,53,171,224
2012-09-07 11:00:00,0,1,81,215,296
2012-09-07 12:00:00,0,1,76,247,323
2012-09-07 13:00:00,0,1,71,283,354
2012-09-07 14:00:00,0,1,66,187,253
2012-09-07 15:00:00,0,1,66,265,331
2012-09-07 16:00:00,0,1,75,395,470
2012-09-07 17:00:00,0,1,88,684,772
2012-09-07 18:00:00,0,1,95,697,792
2012-09-07 19:00:00,0,1,70,498,568
2012-09-07 20:00:00,0,1,51,340,391
2012-09-07 21:00:00,0,1,55,246,301
2012-09-07 22:00:00,0,1,52,247,299
2012-09-07 23:00:00,0,1,28,220,248
2012-09-08 00:00:00,0,0,20,130,150
2012-09-08 01:00:00,0,0,10,107,117
2012-09-08 02:00:00,0,0,9,68,77
2012-09-08 03:00:00,0,0,3,40,43
2012-09-08 04:00:00,0,0,3,8,11
2012-09-08 05:00:00,0,0,2,13,15
2012-09-08 06:00:00,0,0,8,26,34
2012-09-08 07:00:00,0,0,11,71,82
2012-09-08 08:00:00,0,0,33,197,230
2012-09-08 09:00:00,0,0,87,261,348
2012-09-08 10:00:00,0,0,100,322,422
2012-09-08 11:00:00,0,0,173,405,578
2012-09-08 12:00:00,0,0,220,474,694
2012-09-08 13:00:00,0,0,233,435,668
2012-09-08 14:00:00,0,0,260,366,626
2012-09-08 15:00:00,0,0,175,337,512
2012-09-08 16:00:00,0,0,19,95,114
2012-09-08 17:00:00,0,0,52,119,171
2012-09-08 18:00:00,0,0,27,140,167
2012-09-08 19:00:00,0,0,28,187,215
2012-09-08 20:00:00,0,0,28,166,194
2012-09-08 21:00:00,0,0,26,155,181
2012-09-08 22:00:00,0,0,18,176,194
2012-09-08 23:00:00,0,0,12,121,133
2012-09-09 00:00:00,0,0,18,106,124
2012-09-09 01:00:00,0,0,20,104,124
2012-09-09 02:00:00,0,0,15,81,96
2012-09-09 03:00:00,0,0,14,32,46
2012-09-09 04:00:00,0,0,12,16,28
2012-09-09 05:00:00,0,0,16,39,55
2012-09-09 06:00:00,0,0,11,24,35
2012-09-09 07:00:00,0,0,20,50,70
2012-09-09 08:00:00,0,0,27,143,170
2012-09-09 09:00:00,0,0,85,214,299
2012-09-09 10:00:00,0,0,172,323,495
2012-09-09 11:00:00,0,0,194,391,585
2012-09-09 12:00:00,0,0,247,510,757
2012-09-09 13:00:00,0,0,238,491,729
2012-09-09 14:00:00,0,0,232,415,647
2012-09-09 15:00:00,0,0,284,412,696
2012-09-09 16:00:00,0,0,228,473,701
2012-09-09 17:00:00,0,0,213,458,671
2012-09-09 18:00:00,0,0,156,404,560
2012-09-09 19:00:00,0,0,134,362,496
2012-09-09 20:00:00,0,0,91,265,356
2012-09-09 21:00:00,0,0,57,149,206
2012-09-09 22:00:00,0,0,64,125,189
2012-09-09 23:00:00,0,0,22,70,92
2012-09-10 00:00:00,0,1,6,35,41
2012-09-10 01:00:00,0,1,7,11,18
2012-09-10 02:00:00,0,1,11,6,17
2012-09-10 03:00:00,0,1,5,7,12
2012-09-10 04:00:00,0,1,1,4,5
2012-09-10 05:00:00,0,1,4,36,40
2012-09-10 06:00:00,0,1,8,172,180
2012-09-10 07:00:00,0,1,20,427,447
2012-09-10 08:00:00,0,1,33,697,730
2012-09-10 09:00:00,0,1,40,321,361
2012-09-10 10:00:00,0,1,42,168,210
2012-09-10 11:00:00,0,1,69,167,236
2012-09-10 12:00:00,0,1,76,256,332
2012-09-10 13:00:00,0,1,72,251,323
2012-09-10 14:00:00,0,1,107,233,340
2012-09-10 15:00:00,0,1,115,231,346
2012-09-10 16:00:00,0,1,108,380,488
2012-09-10 17:00:00,0,1,127,744,871
2012-09-10 18:00:00,0,1,111,857,968
2012-09-10 19:00:00,0,1,71,562,633
2012-09-10 20:00:00,0,1,34,356,390
2012-09-10 21:00:00,0,1,29,256,285
2012-09-10 22:00:00,0,1,15,144,159
2012-09-10 23:00:00,0,1,7,86,93
2012-09-11 00:00:00,0,1,5,27,32
2012-09-11 01:00:00,0,1,0,10,10
2012-09-11 02:00:00,0,1,1,5,6
2012-09-11 03:00:00,0,1,1,7,8
2012-09-11 04:00:00,0,1,1,8,9
2012-09-11 05:00:00,0,1,3,41,44
2012-09-11 06:00:00,0,1,11,200,211
2012-09-11 07:00:00,0,1,24,572,596
2012-09-11 08:00:00,0,1,48,702,750
2012-09-11 09:00:00,0,1,35,323,358
2012-09-11 10:00:00,0,1,54,142,196
2012-09-11 11:00:00,0,1,60,187,247
2012-09-11 12:00:00,0,1,62,254,316
2012-09-11 13:00:00,0,1,72,256,328
2012-09-11 14:00:00,0,1,74,181,255
2012-09-11 15:00:00,0,1,73,253,326
2012-09-11 16:00:00,0,1,99,437,536
2012-09-11 17:00:00,0,1,168,802,970
2012-09-11 18:00:00,0,1,110,767,877
2012-09-11 19:00:00,0,1,56,540,596
2012-09-11 20:00:00,0,1,40,421,461
2012-09-11 21:00:00,0,1,28,282,310
2012-09-11 22:00:00,0,1,27,189,216
2012-09-11 23:00:00,0,1,18,91,109
2012-09-12 00:00:00,0,1,8,41,49
2012-09-12 01:00:00,0,1,2,19,21
2012-09-12 02:00:00,0,1,2,9,11
2012-09-12 03:00:00,0,1,0,7,7
2012-09-12 04:00:00,0,1,0,5,5
2012-09-12 05:00:00,0,1,4,44,48
2012-09-12 06:00:00,0,1,6,199,205
2012-09-12 07:00:00,0,1,24,533,557
2012-09-12 08:00:00,0,1,43,727,770
2012-09-12 09:00:00,0,1,50,278,328
2012-09-12 10:00:00,0,1,57,148,205
2012-09-12 11:00:00,0,1,51,181,232
2012-09-12 12:00:00,0,1,88,264,352
2012-09-12 13:00:00,0,1,85,238,323
2012-09-12 14:00:00,0,1,78,200,278
2012-09-12 15:00:00,0,1,75,243,318
2012-09-12 16:00:00,0,1,90,419,509
2012-09-12 17:00:00,0,1,114,811,925
2012-09-12 18:00:00,0,1,91,886,977
2012-09-12 19:00:00,0,1,78,557,635
2012-09-12 20:00:00,0,1,38,432,470
2012-09-12 21:00:00,0,1,27,279,306
2012-09-12 22:00:00,0,1,23,189,212
2012-09-12 23:00:00,0,1,16,111,127
2012-09-13 00:00:00,0,1,11,46,57
2012-09-13 01:00:00,0,1,6,22,28
2012-09-13 02:00:00,0,1,0,9,9
2012-09-13 03:00:00,0,1,2,9,11
2012-09-13 04:00:00,0,1,0,6,6
2012-09-13 05:00:00,0,1,3,54,57
2012-09-13 06:00:00,0,1,9,186,195
2012-09-13 07:00:00,0,1,22,549,571
2012-09-13 08:00:00,0,1,33,725,758
2012-09-13 09:00:00,0,1,46,292,338
2012-09-13 10:00:00,0,1,63,149,212
2012-09-13 11:00:00,0,1,71,183,254
2012-09-13 12:00:00,0,1,57,240,297
2012-09-13 13:00:00,0,1,60,223,283
2012-09-13 14:00:00,0,1,60,214,274
2012-09-13 15:00:00,0,1,99,253,352
2012-09-13 16:00:00,0,1,85,406,491
2012-09-13 17:00:00,0,1,97,787,884
2012-09-13 18:00:00,0,1,108,744,852
2012-09-13 19:00:00,0,1,80,594,674
2012-09-13 20:00:00,0,1,55,408,463
2012-09-13 21:00:00,0,1,26,291,317
2012-09-13 22:00:00,0,1,28,223,251
2012-09-13 23:00:00,0,1,33,137,170
2012-09-14 00:00:00,0,1,24,63,87
2012-09-14 01:00:00,0,1,6,35,41
2012-09-14 02:00:00,0,1,7,23,30
2012-09-14 03:00:00,0,1,5,9,14
2012-09-14 04:00:00,0,1,1,11,12
2012-09-14 05:00:00,0,1,1,40,41
2012-09-14 06:00:00,0,1,8,144,152
2012-09-14 07:00:00,0,1,17,437,454
2012-09-14 08:00:00,0,1,51,715,766
2012-09-14 09:00:00,0,1,46,301,347
2012-09-14 10:00:00,0,1,75,171,246
2012-09-14 11:00:00,0,1,84,196,280
2012-09-14 12:00:00,0,1,119,290,409
2012-09-14 13:00:00,0,1,107,301,408
2012-09-14 14:00:00,0,1,113,258,371
2012-09-14 15:00:00,0,1,94,273,367
2012-09-14 16:00:00,0,1,109,454,563
2012-09-14 17:00:00,0,1,137,757,894
2012-09-14 18:00:00,0,1,116,692,808
2012-09-14 19:00:00,0,1,83,496,579
2012-09-14 20:00:00,0,1,67,337,404
2012-09-14 21:00:00,0,1,42,270,312
2012-09-14 22:00:00,0,1,40,189,229
2012-09-14 23:00:00,0,1,27,168,195
2012-09-15 00:00:00,0,0,38,169,207
2012-09-15 01:00:00,0,0,8,101,109
2012-09-15 02:00:00,0,0,18,75,93
2012-09-15 03:00:00,0,0,6,31,37
2012-09-15 04:00:00,0,0,3,3,6
2012-09-15 05:00:00,0,0,1,15,16
2012-09-15 06:00:00,0,0,6,27,33
2012-09-15 07:00:00,0,0,10,63,73
2012-09-15 08:00:00,0,0,43,169,212
2012-09-15 09:00:00,0,0,79,263,342
2012-09-15 10:00:00,0,0,119,323,442
2012-09-15 11:00:00,0,0,228,399,627
2012-09-15 12:00:00,0,0,287,419,706
2012-09-15 13:00:00,0,0,327,377,704
2012-09-15 14:00:00,0,0,325,390,715
2012-09-15 15:00:00,0,0,312,342,654
2012-09-15 16:00:00,0,0,350,433,783
2012-09-15 17:00:00,0,0,295,434,729
2012-09-15 18:00:00,0,0,232,382,614
2012-09-15 19:00:00,0,0,169,309,478
2012-09-15 20:00:00,0,0,89,241,330
2012-09-15 21:00:00,0,0,86,210,296
2012-09-15 22:00:00,0,0,82,197,279
2012-09-15 23:00:00,0,0,47,182,229
2012-09-16 00:00:00,0,0,28,123,151
2012-09-16 01:00:00,0,0,35,82,117
2012-09-16 02:00:00,0,0,27,62,89
2012-09-16 03:00:00,0,0,10,38,48
2012-09-16 04:00:00,0,0,2,6,8
2012-09-16 05:00:00,0,0,3,10,13
2012-09-16 06:00:00,0,0,9,26,35
2012-09-16 07:00:00,0,0,28,43,71
2012-09-16 08:00:00,0,0,34,94,128
2012-09-16 09:00:00,0,0,70,226,296
2012-09-16 10:00:00,0,0,160,330,490
2012-09-16 11:00:00,0,0,183,376,559
2012-09-16 12:00:00,0,0,188,468,656
2012-09-16 13:00:00,0,0,240,454,694
2012-09-16 14:00:00,0,0,225,410,635
2012-09-16 15:00:00,0,0,215,342,557
2012-09-16 16:00:00,0,0,194,402,596
2012-09-16 17:00:00,0,0,177,393,570
2012-09-16 18:00:00,0,0,120,361,481
2012-09-16 19:00:00,0,0,91,312,403
2012-09-16 20:00:00,0,0,57,267,324
2012-09-16 21:00:00,0,0,43,148,191
2012-09-16 22:00:00,0,0,18,109,127
2012-09-16 23:00:00,0,0,9,85,94
2012-09-17 00:00:00,0,1,14,31,45
2012-09-17 01:00:00,0,1,9,12,21
2012-09-17 02:00:00,0,1,5,8,13
2012-09-17 03:00:00,0,1,0,7,7
2012-09-17 04:00:00,0,1,2,9,11
2012-09-17 05:00:00,0,1,1,44,45
2012-09-17 06:00:00,0,1,7,157,164
2012-09-17 07:00:00,0,1,18,474,492
2012-09-17 08:00:00,0,1,36,647,683
2012-09-17 09:00:00,0,1,34,265,299
2012-09-17 10:00:00,0,1,73,129,202
2012-09-17 11:00:00,0,1,61,191,252
2012-09-17 12:00:00,0,1,62,233,295
2012-09-17 13:00:00,0,1,112,231,343
2012-09-17 14:00:00,0,1,129,203,332
2012-09-17 15:00:00,0,1,82,256,338
2012-09-17 16:00:00,0,1,74,379,453
2012-09-17 17:00:00,0,1,102,740,842
2012-09-17 18:00:00,0,1,66,708,774
2012-09-17 19:00:00,0,1,51,435,486
2012-09-17 20:00:00,0,1,32,308,340
2012-09-17 21:00:00,0,1,28,205,233
2012-09-17 22:00:00,0,1,20,109,129
2012-09-17 23:00:00,0,1,4,66,70
2012-09-18 00:00:00,0,1,2,11,13
2012-09-18 01:00:00,0,1,0,5,5
2012-09-18 02:00:00,0,1,0,4,4
2012-09-18 03:00:00,0,1,0,6,6
2012-09-18 04:00:00,0,1,2,5,7
2012-09-18 05:00:00,0,1,3,45,48
2012-09-18 06:00:00,0,1,4,163,167
2012-09-18 07:00:00,0,1,13,343,356
2012-09-18 08:00:00,0,1,32,640,672
2012-09-18 09:00:00,0,1,27,266,293
2012-09-18 10:00:00,0,1,30,130,160
2012-09-18 11:00:00,0,1,36,115,151
2012-09-18 12:00:00,0,1,16,72,88
2012-09-18 13:00:00,0,1,17,97,114
2012-09-18 14:00:00,0,1,27,116,143
2012-09-18 15:00:00,0,1,1,35,36
2012-09-18 16:00:00,0,1,19,122,141
2012-09-18 17:00:00,0,1,36,302,338
2012-09-18 18:00:00,0,1,19,262,281
2012-09-18 19:00:00,0,1,22,302,324
2012-09-18 20:00:00,0,1,19,271,290
2012-09-18 21:00:00,0,1,21,186,207
2012-09-18 22:00:00,0,1,14,137,151
2012-09-18 23:00:00,0,1,11,67,78
2012-09-19 00:00:00,0,1,3,23,26
2012-09-19 01:00:00,0,1,0,12,12
2012-09-19 02:00:00,0,1,0,3,3
2012-09-19 03:00:00,0,1,1,4,5
2012-09-19 04:00:00,0,1,0,10,10
2012-09-19 05:00:00,0,1,2,54,56
2012-09-19 06:00:00,0,1,6,166,172
2012-09-19 07:00:00,0,1,16,529,545
2012-09-19 08:00:00,0,1,39,758,797
2012-09-19 09:00:00,0,1,26,336,362
2012-09-19 10:00:00,0,1,23,169,192
2012-09-19 11:00:00,0,1,44,203,247
2012-09-19 12:00:00,0,1,53,260,313
2012-09-19 13:00:00,0,1,55,234,289
2012-09-19 14:00:00,0,1,59,227,286
2012-09-19 15:00:00,0,1,57,254,311
2012-09-19 16:00:00,0,1,69,397,466
2012-09-19 17:00:00,0,1,74,812,886
2012-09-19 18:00:00,0,1,85,807,892
2012-09-19 19:00:00,0,1,72,539,611
2012-09-19 20:00:00,0,1,31,378,409
2012-09-19 21:00:00,0,1,25,324,349
2012-09-19 22:00:00,0,1,31,198,229
2012-09-19 23:00:00,0,1,17,106,123
2012-10-01 00:00:00,0,1,6,39,45
2012-10-01 01:00:00,0,1,5,13,18
2012-10-01 02:00:00,0,1,6,6,12
2012-10-01 03:00:00,0,1,1,6,7
2012-10-01 04:00:00,0,1,0,10,10
2012-10-01 05:00:00,0,1,2,34,36
2012-10-01 06:00:00,0,1,8,147,155
2012-10-01 07:00:00,0,1,13,470,483
2012-10-01 08:00:00,0,1,40,744,784
2012-10-01 09:00:00,0,1,26,314,340
2012-10-01 10:00:00,0,1,44,135,179
2012-10-01 11:00:00,0,1,76,196,272
2012-10-01 12:00:00,0,1,61,262,323
2012-10-01 13:00:00,0,1,80,225,305
2012-10-01 14:00:00,0,1,51,193,244
2012-10-01 15:00:00,0,1,95,234,329
2012-10-01 16:00:00,0,1,51,408,459
2012-10-01 17:00:00,0,1,65,791,856
2012-10-01 18:00:00,0,1,42,571,613
2012-10-01 19:00:00,0,1,33,483,516
2012-10-01 20:00:00,0,1,11,251,262
2012-10-01 21:00:00,0,1,13,205,218
2012-10-01 22:00:00,0,1,17,190,207
2012-10-01 23:00:00,0,1,17,88,105
2012-10-02 00:00:00,0,1,1,30,31
2012-10-02 01:00:00,0,1,0,11,11
2012-10-02 02:00:00,0,1,0,2,2
2012-10-02 03:00:00,0,1,1,4,5
2012-10-02 04:00:00,0,1,2,8,10
2012-10-02 05:00:00,0,1,1,42,43
2012-10-02 06:00:00,0,1,3,176,179
2012-10-02 07:00:00,0,1,4,256,260
2012-10-02 08:00:00,0,1,6,128,134
2012-10-02 09:00:00,0,1,3,83,86
2012-10-02 10:00:00,0,1,3,42,45
2012-10-02 11:00:00,0,1,7,92,99
2012-10-02 12:00:00,0,1,6,98,104
2012-10-02 13:00:00,0,1,6,148,154
2012-10-02 14:00:00,0,1,16,147,163
2012-10-02 15:00:00,0,1,14,195,209
2012-10-02 16:00:00,0,1,46,328,374
2012-10-02 17:00:00,0,1,38,677,715
2012-10-02 18:00:00,0,1,48,639,687
2012-10-02 19:00:00,0,1,27,368,395
2012-10-02 20:00:00,0,1,20,286,306
2012-10-02 21:00:00,0,1,24,265,289
2012-10-02 22:00:00,0,1,28,212,240
2012-10-02 23:00:00,0,1,11,87,98
2012-10-03 00:00:00,0,1,5,47,52
2012-10-03 01:00:00,0,1,3,16,19
2012-10-03 02:00:00,0,1,2,7,9
2012-10-03 03:00:00,0,1,0,7,7
2012-10-03 04:00:00,0,1,2,9,11
2012-10-03 05:00:00,0,1,2,32,34
2012-10-03 06:00:00,0,1,4,173,177
2012-10-03 07:00:00,0,1,11,504,515
2012-10-03 08:00:00,0,1,28,781,809
2012-10-03 09:00:00,0,1,30,332,362
2012-10-03 10:00:00,0,1,29,146,175
2012-10-03 11:00:00,0,1,52,178,230
2012-10-03 12:00:00,0,1,69,289,358
2012-10-03 13:00:00,0,1,55,224,279
2012-10-03 14:00:00,0,1,56,195,251
2012-10-03 15:00:00,0,1,59,260,319
2012-10-03 16:00:00,0,1,42,436,478
2012-10-03 17:00:00,0,1,84,833,917
2012-10-03 18:00:00,0,1,54,756,810
2012-10-03 19:00:00,0,1,49,544,593
2012-10-03 20:00:00,0,1,48,449,497
2012-10-03 21:00:00,0,1,14,195,209
2012-10-03 22:00:00,0,1,9,232,241
2012-10-03 23:00:00,0,1,21,199,220
2012-10-04 00:00:00,0,1,11,65,76
2012-10-04 01:00:00,0,1,2,23,25
2012-10-04 02:00:00,0,1,3,10,13
2012-10-04 03:00:00,0,1,5,6,11
2012-10-04 04:00:00,0,1,0,10,10
2012-10-04 05:00:00,0,1,2,37,39
2012-10-04 06:00:00,0,1,1,132,133
2012-10-04 07:00:00,0,1,12,379,391
2012-10-04 08:00:00,0,1,27,711,738
2012-10-04 09:00:00,0,1,40,319,359
2012-10-04 10:00:00,0,1,27,150,177
2012-10-04 11:00:00,0,1,38,176,214
2012-10-04 12:00:00,0,1,57,231,288
2012-10-04 13:00:00,0,1,63,231,294
2012-10-04 14:00:00,0,1,56,211,267
2012-10-04 15:00:00,0,1,77,248,325
2012-10-04 16:00:00,0,1,86,411,497
2012-10-04 17:00:00,0,1,112,789,901
2012-10-04 18:00:00,0,1,75,812,887
2012-10-04 19:00:00,0,1,67,467,534
2012-10-04 20:00:00,0,1,50,391,441
2012-10-04 21:00:00,0,1,33,288,321
2012-10-04 22:00:00,0,1,29,203,232
2012-10-04 23:00:00,0,1,18,137,155
2012-10-05 00:00:00,0,1,16,86,102
2012-10-05 01:00:00,0,1,3,43,46
2012-10-05 02:00:00,0,1,1,10,11
2012-10-05 03:00:00,0,1,5,11,16
2012-10-05 04:00:00,0,1,0,11,11
2012-10-05 05:00:00,0,1,0,41,41
2012-10-05 06:00:00,0,1,4,133,137
2012-10-05 07:00:00,0,1,11,417,428
2012-10-05 08:00:00,0,1,36,749,785
2012-10-05 09:00:00,0,1,58,326,384
2012-10-05 10:00:00,0,1,68,192,260
2012-10-05 11:00:00,0,1,90,214,304
2012-10-05 12:00:00,0,1,161,307,468
2012-10-05 13:00:00,0,1,117,307,424
2012-10-05 14:00:00,0,1,113,287,400
2012-10-05 15:00:00,0,1,150,320,470
2012-10-05 16:00:00,0,1,153,481,634
2012-10-05 17:00:00,0,1,158,742,900
2012-10-05 18:00:00,0,1,106,655,761
2012-10-05 19:00:00,0,1,67,433,500
2012-10-05 20:00:00,0,1,66,306,372
2012-10-05 21:00:00,0,1,47,220,267
2012-10-05 22:00:00,0,1,63,201,264
2012-10-05 23:00:00,0,1,23,148,171
2012-10-06 00:00:00,0,0,37,154,191
2012-10-06 01:00:00,0,0,25,116,141
2012-10-06 02:00:00,0,0,13,62,75
2012-10-06 03:00:00,0,0,2,54,56
2012-10-06 04:00:00,0,0,4,7,11
2012-10-06 05:00:00,0,0,2,8,10
2012-10-06 06:00:00,0,0,2,28,30
2012-10-06 07:00:00,0,0,13,71,84
2012-10-06 08:00:00,0,0,22,184,206
2012-10-06 09:00:00,0,0,130,265,395
2012-10-06 10:00:00,0,0,198,341,539
2012-10-06 11:00:00,0,0,258,389,647
2012-10-06 12:00:00,0,0,362,381,743
2012-10-06 13:00:00,0,0,310,400,710
2012-10-06 14:00:00,0,0,269,307,576
2012-10-06 15:00:00,0,0,279,341,620
2012-10-06 16:00:00,0,0,317,342,659
2012-10-06 17:00:00,0,0,268,342,610
2012-10-06 18:00:00,0,0,183,312,495
2012-10-06 19:00:00,0,0,102,239,341
2012-10-06 20:00:00,0,0,75,172,247
2012-10-06 21:00:00,0,0,78,137,215
2012-10-06 22:00:00,0,0,45,140,185
2012-10-06 23:00:00,0,0,37,142,179
2012-10-07 00:00:00,0,0,28,99,127
2012-10-07 01:00:00,0,0,29,80,109
2012-10-07 02:00:00,0,0,10,64,74
2012-10-07 03:00:00,0,0,5,17,22
2012-10-07 04:00:00,0,0,5,6,11
2012-10-07 05:00:00,0,0,2,8,10
2012-10-07 06:00:00,0,0,4,19,23
2012-10-07 07:00:00,0,0,6,29,35
2012-10-07 08:00:00,0,0,11,51,62
2012-10-07 09:00:00,0,0,16,70,86
2012-10-07 10:00:00,0,0,41,144,185
2012-10-07 11:00:00,0,0,76,260,336
2012-10-07 12:00:00,0,0,100,292,392
2012-10-07 13:00:00,0,0,80,240,320
2012-10-07 14:00:00,0,0,71,243,314
2012-10-07 15:00:00,0,0,74,232,306
2012-10-07 16:00:00,0,0,87,246,333
2012-10-07 17:00:00,0,0,35,122,157
2012-10-07 18:00:00,0,0,24,82,106
2012-10-07 19:00:00,0,0,17,97,114
2012-10-07 20:00:00,0,0,19,97,116
2012-10-07 21:00:00,0,0,22,91,113
2012-10-07 22:00:00,0,0,7,72,79
2012-10-07 23:00:00,0,0,12,68,80
2012-10-08 00:00:00,1,0,7,44,51
2012-10-08 01:00:00,1,0,2,35,37
2012-10-08 02:00:00,1,0,3,12,15
2012-10-08 03:00:00,1,0,2,8,10
2012-10-08 04:00:00,1,0,1,6,7
2012-10-08 05:00:00,1,0,2,17,19
2012-10-08 06:00:00,1,0,5,54,59
2012-10-08 07:00:00,1,0,3,151,154
2012-10-08 08:00:00,1,0,23,374,397
2012-10-08 09:00:00,1,0,59,273,332
2012-10-08 10:00:00,1,0,69,229,298
2012-10-08 11:00:00,1,0,72,236,308
2012-10-08 12:00:00,1,0,74,267,341
2012-10-08 13:00:00,1,0,82,323,405
2012-10-08 14:00:00,1,0,121,299,420
2012-10-08 15:00:00,1,0,76,294,370
2012-10-08 16:00:00,1,0,61,316,377
2012-10-08 17:00:00,1,0,81,416,497
2012-10-08 18:00:00,1,0,41,415,456
2012-10-08 19:00:00,1,0,38,333,371
2012-10-08 20:00:00,1,0,20,207,227
2012-10-08 21:00:00,1,0,17,134,151
2012-10-08 22:00:00,1,0,6,101,107
2012-10-08 23:00:00,1,0,9,60,69
2012-10-09 00:00:00,0,1,9,22,31
2012-10-09 01:00:00,0,1,0,13,13
2012-10-09 02:00:00,0,1,2,5,7
2012-10-09 03:00:00,0,1,0,3,3
2012-10-09 04:00:00,0,1,1,6,7
2012-10-09 05:00:00,0,1,0,19,19
2012-10-09 06:00:00,0,1,2,141,143
2012-10-09 07:00:00,0,1,5,357,362
2012-10-09 08:00:00,0,1,15,698,713
2012-10-09 09:00:00,0,1,37,345,382
2012-10-09 10:00:00,0,1,33,131,164
2012-10-09 11:00:00,0,1,37,156,193
2012-10-09 12:00:00,0,1,43,217,260
2012-10-09 13:00:00,0,1,54,184,238
2012-10-09 14:00:00,0,1,43,201,244
2012-10-09 15:00:00,0,1,59,195,254
2012-10-09 16:00:00,0,1,70,354,424
2012-10-09 17:00:00,0,1,73,733,806
2012-10-09 18:00:00,0,1,26,758,784
2012-10-09 19:00:00,0,1,31,483,514
2012-10-09 20:00:00,0,1,30,330,360
2012-10-09 21:00:00,0,1,16,209,225
2012-10-09 22:00:00,0,1,7,155,162
2012-10-09 23:00:00,0,1,8,76,84
2012-10-10 00:00:00,0,1,0,33,33
2012-10-10 01:00:00,0,1,2,6,8
2012-10-10 02:00:00,0,1,2,6,8
2012-10-10 03:00:00,0,1,0,6,6
2012-10-10 04:00:00,0,1,0,6,6
2012-10-10 05:00:00,0,1,2,38,40
2012-10-10 06:00:00,0,1,3,172,175
2012-10-10 07:00:00,0,1,9,498,507
2012-10-10 08:00:00,0,1,33,806,839
2012-10-10 09:00:00,0,1,35,331,366
2012-10-10 10:00:00,0,1,27,190,217
2012-10-10 11:00:00,0,1,53,238,291
2012-10-10 12:00:00,0,1,78,312,390
2012-10-10 13:00:00,0,1,60,237,297
2012-10-10 14:00:00,0,1,63,208,271
2012-10-10 15:00:00,0,1,58,261,319
2012-10-10 16:00:00,0,1,92,474,566
2012-10-10 17:00:00,0,1,91,857,948
2012-10-10 18:00:00,0,1,57,787,844
2012-10-10 19:00:00,0,1,32,534,566
2012-10-10 20:00:00,0,1,21,371,392
2012-10-10 21:00:00,0,1,18,251,269
2012-10-10 22:00:00,0,1,27,170,197
2012-10-10 23:00:00,0,1,17,119,136
2012-10-11 00:00:00,0,1,1,41,42
2012-10-11 01:00:00,0,1,1,10,11
2012-10-11 02:00:00,0,1,4,7,11
2012-10-11 03:00:00,0,1,0,3,3
2012-10-11 04:00:00,0,1,0,10,10
2012-10-11 05:00:00,0,1,0,42,42
2012-10-11 06:00:00,0,1,1,158,159
2012-10-11 07:00:00,0,1,11,467,478
2012-10-11 08:00:00,0,1,25,773,798
2012-10-11 09:00:00,0,1,27,328,355
2012-10-11 10:00:00,0,1,39,165,204
2012-10-11 11:00:00,0,1,76,175,251
2012-10-11 12:00:00,0,1,47,279,326
2012-10-11 13:00:00,0,1,48,243,291
2012-10-11 14:00:00,0,1,78,270,348
2012-10-11 15:00:00,0,1,102,358,460
2012-10-11 16:00:00,0,1,68,413,481
2012-10-11 17:00:00,0,1,90,737,827
2012-10-11 18:00:00,0,1,64,628,692
2012-10-11 19:00:00,0,1,81,662,743
2012-10-11 20:00:00,0,1,27,388,415
2012-10-11 21:00:00,0,1,24,236,260
2012-10-11 22:00:00,0,1,10,167,177
2012-10-11 23:00:00,0,1,10,176,186
2012-10-12 00:00:00,0,1,8,60,68
2012-10-12 01:00:00,0,1,8,29,37
2012-10-12 02:00:00,0,1,0,16,16
2012-10-12 03:00:00,0,1,0,6,6
2012-10-12 04:00:00,0,1,0,8,8
2012-10-12 05:00:00,0,1,2,33,35
2012-10-12 06:00:00,0,1,3,140,143
2012-10-12 07:00:00,0,1,8,384,392
2012-10-12 08:00:00,0,1,34,711,745
2012-10-12 09:00:00,0,1,26,374,400
2012-10-12 10:00:00,0,1,75,200,275
2012-10-12 11:00:00,0,1,61,252,313
2012-10-12 12:00:00,0,1,75,312,387
2012-10-12 13:00:00,0,1,81,300,381
2012-10-12 14:00:00,0,1,109,262,371
2012-10-12 15:00:00,0,1,138,317,455
2012-10-12 16:00:00,0,1,108,412,520
2012-10-12 17:00:00,0,1,131,706,837
2012-10-12 18:00:00,0,1,76,566,642
2012-10-12 19:00:00,0,1,40,453,493
2012-10-12 20:00:00,0,1,28,280,308
2012-10-12 21:00:00,0,1,21,169,190
2012-10-12 22:00:00,0,1,17,143,160
2012-10-12 23:00:00,0,1,11,89,100
2012-10-13 00:00:00,0,0,31,218,249
2012-10-13 01:00:00,0,0,23,123,146
2012-10-13 02:00:00,0,0,7,60,67
2012-10-13 03:00:00,0,0,2,13,15
2012-10-13 04:00:00,0,0,2,9,11
2012-10-13 05:00:00,0,0,0,11,11
2012-10-13 06:00:00,0,0,5,23,28
2012-10-13 07:00:00,0,0,10,60,70
2012-10-13 08:00:00,0,0,23,151,174
2012-10-13 09:00:00,0,0,46,220,266
2012-10-13 10:00:00,0,0,82,265,347
2012-10-13 11:00:00,0,0,192,335,527
2012-10-13 12:00:00,0,0,202,371,573
2012-10-13 13:00:00,0,0,235,435,670
2012-10-13 14:00:00,0,0,243,354,597
2012-10-13 15:00:00,0,0,251,364,615
2012-10-13 16:00:00,0,0,294,343,637
2012-10-13 17:00:00,0,0,193,335,528
2012-10-13 18:00:00,0,0,174,299,473
2012-10-13 19:00:00,0,0,73,259,332
2012-10-13 20:00:00,0,0,57,198,255
2012-10-13 21:00:00,0,0,47,157,204
2012-10-13 22:00:00,0,0,33,156,189
2012-10-13 23:00:00,0,0,27,98,125
2012-10-14 00:00:00,0,0,8,103,111
2012-10-14 01:00:00,0,0,16,96,112
2012-10-14 02:00:00,0,0,8,58,66
2012-10-14 03:00:00,0,0,3,25,28
2012-10-14 04:00:00,0,0,2,10,12
2012-10-14 05:00:00,0,0,5,6,11
2012-10-14 06:00:00,0,0,4,20,24
2012-10-14 07:00:00,0,0,7,44,51
2012-10-14 08:00:00,0,0,28,104,132
2012-10-14 09:00:00,0,0,62,161,223
2012-10-14 10:00:00,0,0,150,278,428
2012-10-14 11:00:00,0,0,156,338,494
2012-10-14 12:00:00,0,0,200,362,562
2012-10-14 13:00:00,0,0,218,401,619
2012-10-14 14:00:00,0,0,249,368,617
2012-10-14 15:00:00,0,0,213,355,568
2012-10-14 16:00:00,0,0,203,378,581
2012-10-14 17:00:00,0,0,193,346,539
2012-10-14 18:00:00,0,0,134,319,453
2012-10-14 19:00:00,0,0,68,268,336
2012-10-14 20:00:00,0,0,48,198,246
2012-10-14 21:00:00,0,0,40,156,196
2012-10-14 22:00:00,0,0,38,87,125
2012-10-14 23:00:00,0,0,27,78,105
2012-10-15 00:00:00,0,1,17,31,48
2012-10-15 01:00:00,0,1,5,24,29
2012-10-15 02:00:00,0,1,1,5,6
2012-10-15 03:00:00,0,1,2,2,4
2012-10-15 04:00:00,0,1,1,9,10
2012-10-15 05:00:00,0,1,2,38,40
2012-10-15 06:00:00,0,1,6,141,147
2012-10-15 07:00:00,0,1,15,461,476
2012-10-15 08:00:00,0,1,24,713,737
2012-10-15 09:00:00,0,1,31,328,359
2012-10-15 10:00:00,0,1,43,125,168
2012-10-15 11:00:00,0,1,88,175,263
2012-10-15 12:00:00,0,1,73,211,284
2012-10-15 13:00:00,0,1,37,109,146
2012-10-15 14:00:00,0,1,57,128,185
2012-10-15 15:00:00,0,1,70,190,260
2012-10-15 16:00:00,0,1,76,371,447
2012-10-15 17:00:00,0,1,96,670,766
2012-10-15 18:00:00,0,1,52,540,592
2012-10-15 19:00:00,0,1,12,227,239
2012-10-15 20:00:00,0,1,19,237,256
2012-10-15 21:00:00,0,1,16,190,206
2012-10-15 22:00:00,0,1,8,118,126
2012-10-15 23:00:00,0,1,9,72,81
2012-10-16 00:00:00,0,1,3,45,48
2012-10-16 01:00:00,0,1,4,9,13
2012-10-16 02:00:00,0,1,2,1,3
2012-10-16 03:00:00,0,1,0,2,2
2012-10-16 04:00:00,0,1,0,7,7
2012-10-16 05:00:00,0,1,5,47,52
2012-10-16 06:00:00,0,1,4,168,172
2012-10-16 07:00:00,0,1,20,505,525
2012-10-16 08:00:00,0,1,35,800,835
2012-10-16 09:00:00,0,1,32,323,355
2012-10-16 10:00:00,0,1,65,157,222
2012-10-16 11:00:00,0,1,56,172,228
2012-10-16 12:00:00,0,1,69,256,325
2012-10-16 13:00:00,0,1,68,260,328
2012-10-16 14:00:00,0,1,94,214,308
2012-10-16 15:00:00,0,1,76,270,346
2012-10-16 16:00:00,0,1,79,367,446
2012-10-16 17:00:00,0,1,104,839,943
2012-10-16 18:00:00,0,1,71,767,838
2012-10-16 19:00:00,0,1,40,491,531
2012-10-16 20:00:00,0,1,35,397,432
2012-10-16 21:00:00,0,1,19,176,195
2012-10-16 22:00:00,0,1,18,163,181
2012-10-16 23:00:00,0,1,23,176,199
2012-10-17 00:00:00,0,1,1,48,49
2012-10-17 01:00:00,0,1,3,14,17
2012-10-17 02:00:00,0,1,4,12,16
2012-10-17 03:00:00,0,1,0,7,7
2012-10-17 04:00:00,0,1,0,4,4
2012-10-17 05:00:00,0,1,2,39,41
2012-10-17 06:00:00,0,1,7,171,178
2012-10-17 07:00:00,0,1,15,449,464
2012-10-17 08:00:00,0,1,38,779,817
2012-10-17 09:00:00,0,1,38,344,382
2012-10-17 10:00:00,0,1,60,168,228
2012-10-17 11:00:00,0,1,78,156,234
2012-10-17 12:00:00,0,1,71,261,332
2012-10-17 13:00:00,0,1,73,237,310
2012-10-17 14:00:00,0,1,82,188,270
2012-10-17 15:00:00,0,1,62,239,301
2012-10-17 16:00:00,0,1,70,396,466
2012-10-17 17:00:00,0,1,122,766,888
2012-10-17 18:00:00,0,1,90,794,884
2012-10-17 19:00:00,0,1,49,467,516
2012-10-17 20:00:00,0,1,54,360,414
2012-10-17 21:00:00,0,1,28,301,329
2012-10-17 22:00:00,0,1,17,198,215
2012-10-17 23:00:00,0,1,15,84,99
2012-10-18 00:00:00,0,1,4,53,57
2012-10-18 01:00:00,0,1,0,14,14
2012-10-18 02:00:00,0,1,1,13,14
2012-10-18 03:00:00,0,1,0,5,5
2012-10-18 04:00:00,0,1,0,5,5
2012-10-18 05:00:00,0,1,1,41,42
2012-10-18 06:00:00,0,1,3,150,153
2012-10-18 07:00:00,0,1,20,488,508
2012-10-18 08:00:00,0,1,31,803,834
2012-10-18 09:00:00,0,1,41,346,387
2012-10-18 10:00:00,0,1,60,158,218
2012-10-18 11:00:00,0,1,79,189,268
2012-10-18 12:00:00,0,1,93,284,377
2012-10-18 13:00:00,0,1,96,236,332
2012-10-18 14:00:00,0,1,94,191,285
2012-10-18 15:00:00,0,1,69,284,353
2012-10-18 16:00:00,0,1,94,356,450
2012-10-18 17:00:00,0,1,102,788,890
2012-10-18 18:00:00,0,1,68,720,788
2012-10-18 19:00:00,0,1,42,471,513
2012-10-18 20:00:00,0,1,39,348,387
2012-10-18 21:00:00,0,1,38,245,283
2012-10-18 22:00:00,0,1,27,202,229
2012-10-18 23:00:00,0,1,6,111,117
2012-10-19 00:00:00,0,1,5,51,56
2012-10-19 01:00:00,0,1,4,12,16
2012-10-19 02:00:00,0,1,1,9,10
2012-10-19 03:00:00,0,1,0,5,5
2012-10-19 04:00:00,0,1,1,5,6
2012-10-19 05:00:00,0,1,1,35,36
2012-10-19 06:00:00,0,1,5,126,131
2012-10-19 07:00:00,0,1,5,149,154
2012-10-19 08:00:00,0,1,20,447,467
2012-10-19 09:00:00,0,1,26,363,389
2012-10-19 10:00:00,0,1,26,198,224
2012-10-19 11:00:00,0,1,41,211,252
2012-10-19 12:00:00,0,1,74,258,332
2012-10-19 13:00:00,0,1,87,288,375
2012-10-19 14:00:00,0,1,88,277,365
2012-10-19 15:00:00,0,1,93,302,395
2012-10-19 16:00:00,0,1,131,434,565
2012-10-19 17:00:00,0,1,48,377,425
2012-10-19 18:00:00,0,1,21,212,233
2012-10-19 19:00:00,0,1,19,213,232
2012-10-19 20:00:00,0,1,13,216,229
2012-10-19 21:00:00,0,1,17,189,206
2012-10-19 22:00:00,0,1,14,176,190
2012-10-19 23:00:00,0,1,13,118,131
2012-11-01 00:00:00,0,1,8,52,60
2012-11-01 01:00:00,0,1,8,22,30
2012-11-01 02:00:00,0,1,10,10,20
2012-11-01 03:00:00,0,1,5,10,15
2012-11-01 04:00:00,0,1,2,8,10
2012-11-01 05:00:00,0,1,1,39,40
2012-11-01 06:00:00,0,1,2,146,148
2012-11-01 07:00:00,0,1,6,414,420
2012-11-01 08:00:00,0,1,12,668,680
2012-11-01 09:00:00,0,1,21,310,331
2012-11-01 10:00:00,0,1,13,133,146
2012-11-01 11:00:00,0,1,14,156,170
2012-11-01 12:00:00,0,1,23,198,221
2012-11-01 13:00:00,0,1,49,199,248
2012-11-01 14:00:00,0,1,31,154,185
2012-11-01 15:00:00,0,1,35,179,214
2012-11-01 16:00:00,0,1,31,313,344
2012-11-01 17:00:00,0,1,37,652,689
2012-11-01 18:00:00,0,1,50,628,678
2012-11-01 19:00:00,0,1,28,424,452
2012-11-01 20:00:00,0,1,16,280,296
2012-11-01 21:00:00,0,1,29,238,267
2012-11-01 22:00:00,0,1,27,175,202
2012-11-01 23:00:00,0,1,8,112,120
2012-11-02 00:00:00,0,1,10,40,50
2012-11-02 01:00:00,0,1,5,19,24
2012-11-02 02:00:00,0,1,3,7,10
2012-11-02 03:00:00,0,1,0,3,3
2012-11-02 04:00:00,0,1,1,6,7
2012-11-02 05:00:00,0,1,1,25,26
2012-11-02 06:00:00,0,1,2,120,122
2012-11-02 07:00:00,0,1,8,349,357
2012-11-02 08:00:00,0,1,31,656,687
2012-11-02 09:00:00,0,1,27,355,382
2012-11-02 10:00:00,0,1,21,183,204
2012-11-02 11:00:00,0,1,42,179,221
2012-11-02 12:00:00,0,1,52,240,292
2012-11-02 13:00:00,0,1,64,230,294
2012-11-02 14:00:00,0,1,63,199,262
2012-11-02 15:00:00,0,1,51,255,306
2012-11-02 16:00:00,0,1,48,373,421
2012-11-02 17:00:00,0,1,57,581,638
2012-11-02 18:00:00,0,1,32,490,522
2012-11-02 19:00:00,0,1,38,336,374
2012-11-02 20:00:00,0,1,14,207,221
2012-11-02 21:00:00,0,1,23,133,156
2012-11-02 22:00:00,0,1,14,135,149
2012-11-02 23:00:00,0,1,11,108,119
2012-11-03 00:00:00,0,0,9,99,108
2012-11-03 01:00:00,0,0,6,83,89
2012-11-03 02:00:00,0,0,10,36,46
2012-11-03 03:00:00,0,0,6,22,28
2012-11-03 04:00:00,0,0,8,8,16
2012-11-03 05:00:00,0,0,1,8,9
2012-11-03 06:00:00,0,0,4,17,21
2012-11-03 07:00:00,0,0,1,58,59
2012-11-03 08:00:00,0,0,10,132,142
2012-11-03 09:00:00,0,0,31,188,219
2012-11-03 10:00:00,0,0,68,260,328
2012-11-03 11:00:00,0,0,56,284,340
2012-11-03 12:00:00,0,0,74,320,394
2012-11-03 13:00:00,0,0,110,339,449
2012-11-03 14:00:00,0,0,136,319,455
2012-11-03 15:00:00,0,0,117,331,448
2012-11-03 16:00:00,0,0,108,292,400
2012-11-03 17:00:00,0,0,112,298,410
2012-11-03 18:00:00,0,0,58,239,297
2012-11-03 19:00:00,0,0,22,217,239
2012-11-03 20:00:00,0,0,23,158,181
2012-11-03 21:00:00,0,0,31,135,166
2012-11-03 22:00:00,0,0,13,133,146
2012-11-03 23:00:00,0,0,15,133,148
2012-11-04 00:00:00,0,0,5,97,102
2012-11-04 01:00:00,0,0,26,139,165
2012-11-04 02:00:00,0,0,6,31,37
2012-11-04 03:00:00,0,0,1,10,11
2012-11-04 04:00:00,0,0,2,7,9
2012-11-04 05:00:00,0,0,0,5,5
2012-11-04 06:00:00,0,0,2,14,16
2012-11-04 07:00:00,0,0,11,39,50
2012-11-04 08:00:00,0,0,34,115,149
2012-11-04 09:00:00,0,0,56,161,217
2012-11-04 10:00:00,0,0,73,287,360
2012-11-04 11:00:00,0,0,134,311,445
2012-11-04 12:00:00,0,0,150,354,504
2012-11-04 13:00:00,0,0,122,371,493
2012-11-04 14:00:00,0,0,149,360,509
2012-11-04 15:00:00,0,0,149,300,449
2012-11-04 16:00:00,0,0,119,316,435
2012-11-04 17:00:00,0,0,57,270,327
2012-11-04 18:00:00,0,0,31,206,237
2012-11-04 19:00:00,0,0,24,203,227
2012-11-04 20:00:00,0,0,7,134,141
2012-11-04 21:00:00,0,0,16,71,87
2012-11-04 22:00:00,0,0,15,64,79
2012-11-04 23:00:00,0,0,12,41,53
2012-11-05 00:00:00,0,1,3,20,23
2012-11-05 01:00:00,0,1,0,8,8
2012-11-05 02:00:00,0,1,2,4,6
2012-11-05 03:00:00,0,1,1,3,4
2012-11-05 04:00:00,0,1,5,11,16
2012-11-05 05:00:00,0,1,1,38,39
2012-11-05 06:00:00,0,1,4,135,139
2012-11-05 07:00:00,0,1,8,453,461
2012-11-05 08:00:00,0,1,19,629,648
2012-11-05 09:00:00,0,1,18,239,257
2012-11-05 10:00:00,0,1,30,112,142
2012-11-05 11:00:00,0,1,31,119,150
2012-11-05 12:00:00,0,1,38,206,244
2012-11-05 13:00:00,0,1,39,183,222
2012-11-05 14:00:00,0,1,31,165,196
2012-11-05 15:00:00,0,1,24,207,231
2012-11-05 16:00:00,0,1,35,325,360
2012-11-05 17:00:00,0,1,34,604,638
2012-11-05 18:00:00,0,1,19,523,542
2012-11-05 19:00:00,0,1,11,361,372
2012-11-05 20:00:00,0,1,13,228,241
2012-11-05 21:00:00,0,1,8,144,152
2012-11-05 22:00:00,0,1,4,111,115
2012-11-05 23:00:00,0,1,0,53,53
2012-11-06 00:00:00,0,1,1,18,19
2012-11-06 01:00:00,0,1,0,8,8
2012-11-06 02:00:00,0,1,0,2,2
2012-11-06 03:00:00,0,1,0,4,4
2012-11-06 04:00:00,0,1,0,7,7
2012-11-06 05:00:00,0,1,1,40,41
2012-11-06 06:00:00,0,1,6,143,149
2012-11-06 07:00:00,0,1,9,378,387
2012-11-06 08:00:00,0,1,20,568,588
2012-11-06 09:00:00,0,1,25,338,363
2012-11-06 10:00:00,0,1,41,189,230
2012-11-06 11:00:00,0,1,39,177,216
2012-11-06 12:00:00,0,1,31,217,248
2012-11-06 13:00:00,0,1,46,232,278
2012-11-06 14:00:00,0,1,44,196,240
2012-11-06 15:00:00,0,1,45,227,272
2012-11-06 16:00:00,0,1,33,369,402
2012-11-06 17:00:00,0,1,30,597,627
2012-11-06 18:00:00,0,1,20,477,497
2012-11-06 19:00:00,0,1,15,356,371
2012-11-06 20:00:00,0,1,10,218,228
2012-11-06 21:00:00,0,1,14,137,151
2012-11-06 22:00:00,0,1,17,136,153
2012-11-06 23:00:00,0,1,19,186,205
2012-11-07 00:00:00,0,1,49,234,283
2012-11-07 01:00:00,0,1,6,86,92
2012-11-07 02:00:00,0,1,6,68,74
2012-11-07 03:00:00,0,1,2,9,11
2012-11-07 04:00:00,0,1,0,9,9
2012-11-07 05:00:00,0,1,0,27,27
2012-11-07 06:00:00,0,1,3,115,118
2012-11-07 07:00:00,0,1,5,314,319
2012-11-07 08:00:00,0,1,18,583,601
2012-11-07 09:00:00,0,1,17,351,368
2012-11-07 10:00:00,0,1,27,151,178
2012-11-07 11:00:00,0,1,15,132,147
2012-11-07 12:00:00,0,1,24,188,212
2012-11-07 13:00:00,0,1,23,158,181
2012-11-07 14:00:00,0,1,19,142,161
2012-11-07 15:00:00,0,1,20,178,198
2012-11-07 16:00:00,0,1,23,250,273
2012-11-07 17:00:00,0,1,16,501,517
2012-11-07 18:00:00,0,1,17,448,465
2012-11-07 19:00:00,0,1,17,302,319
2012-11-07 20:00:00,0,1,7,249,256
2012-11-07 21:00:00,0,1,5,121,126
2012-11-07 22:00:00,0,1,4,56,60
2012-11-07 23:00:00,0,1,3,37,40
2012-11-08 00:00:00,0,1,1,14,15
2012-11-08 01:00:00,0,1,1,11,12
2012-11-08 02:00:00,0,1,1,5,6
2012-11-08 04:00:00,0,1,1,9,10
2012-11-08 05:00:00,0,1,0,35,35
2012-11-08 06:00:00,0,1,2,122,124
2012-11-08 07:00:00,0,1,12,411,423
2012-11-08 08:00:00,0,1,16,652,668
2012-11-08 09:00:00,0,1,22,253,275
2012-11-08 10:00:00,0,1,13,148,161
2012-11-08 11:00:00,0,1,16,155,171
2012-11-08 12:00:00,0,1,33,202,235
2012-11-08 13:00:00,0,1,33,195,228
2012-11-08 14:00:00,0,1,33,149,182
2012-11-08 15:00:00,0,1,32,201,233
2012-11-08 16:00:00,0,1,18,321,339
2012-11-08 17:00:00,0,1,36,556,592
2012-11-08 18:00:00,0,1,16,491,507
2012-11-08 19:00:00,0,1,14,359,373
2012-11-08 20:00:00,0,1,10,235,245
2012-11-08 21:00:00,0,1,11,222,233
2012-11-08 22:00:00,0,1,14,147,161
2012-11-08 23:00:00,0,1,5,82,87
2012-11-09 00:00:00,0,1,9,46,55
2012-11-09 01:00:00,0,1,3,17,20
2012-11-09 02:00:00,0,1,1,11,12
2012-11-09 03:00:00,0,1,3,6,9
2012-11-09 04:00:00,0,1,0,14,14
2012-11-09 05:00:00,0,1,2,25,27
2012-11-09 06:00:00,0,1,5,126,131
2012-11-09 07:00:00,0,1,9,332,341
2012-11-09 08:00:00,0,1,25,668,693
2012-11-09 09:00:00,0,1,23,304,327
2012-11-09 10:00:00,0,1,34,163,197
2012-11-09 11:00:00,0,1,66,185,251
2012-11-09 12:00:00,0,1,48,214,262
2012-11-09 13:00:00,0,1,62,237,299
2012-11-09 14:00:00,0,1,67,207,274
2012-11-09 15:00:00,0,1,78,278,356
2012-11-09 16:00:00,0,1,57,377,434
2012-11-09 17:00:00,0,1,61,593,654
2012-11-09 18:00:00,0,1,46,450,496
2012-11-09 19:00:00,0,1,30,331,361
2012-11-09 20:00:00,0,1,20,235,255
2012-11-09 21:00:00,0,1,23,176,199
2012-11-09 22:00:00,0,1,17,146,163
2012-11-09 23:00:00,0,1,20,142,162
2012-11-10 00:00:00,0,0,16,106,122
2012-11-10 01:00:00,0,0,8,68,76
2012-11-10 02:00:00,0,0,2,42,44
2012-11-10 03:00:00,0,0,9,11,20
2012-11-10 04:00:00,0,0,2,4,6
2012-11-10 05:00:00,0,0,1,9,10
2012-11-10 06:00:00,0,0,5,11,16
2012-11-10 07:00:00,0,0,14,57,71
2012-11-10 08:00:00,0,0,16,130,146
2012-11-10 09:00:00,0,0,43,216,259
2012-11-10 10:00:00,0,0,86,264,350
2012-11-10 11:00:00,0,0,143,323,466
2012-11-10 12:00:00,0,0,258,348,606
2012-11-10 13:00:00,0,0,268,383,651
2012-11-10 14:00:00,0,0,280,347,627
2012-11-10 15:00:00,0,0,216,351,567
2012-11-10 16:00:00,0,0,227,378,605
2012-11-10 17:00:00,0,0,183,318,501
2012-11-10 18:00:00,0,0,103,256,359
2012-11-10 19:00:00,0,0,55,228,283
2012-11-10 20:00:00,0,0,39,153,192
2012-11-10 21:00:00,0,0,51,169,220
2012-11-10 22:00:00,0,0,39,154,193
2012-11-10 23:00:00,0,0,26,120,146
2012-11-11 00:00:00,0,0,14,110,124
2012-11-11 01:00:00,0,0,26,82,108
2012-11-11 02:00:00,0,0,12,58,70
2012-11-11 03:00:00,0,0,9,39,48
2012-11-11 04:00:00,0,0,5,6,11
2012-11-11 05:00:00,0,0,0,12,12
2012-11-11 06:00:00,0,0,3,16,19
2012-11-11 07:00:00,0,0,12,56,68
2012-11-11 08:00:00,0,0,32,87,119
2012-11-11 09:00:00,0,0,94,179,273
2012-11-11 10:00:00,0,0,133,272,405
2012-11-11 11:00:00,0,0,180,324,504
2012-11-11 12:00:00,0,0,195,390,585
2012-11-11 13:00:00,0,0,262,424,686
2012-11-11 14:00:00,0,0,292,362,654
2012-11-11 15:00:00,0,0,304,420,724
2012-11-11 16:00:00,0,0,260,393,653
2012-11-11 17:00:00,0,0,151,342,493
2012-11-11 18:00:00,0,0,102,303,405
2012-11-11 19:00:00,0,0,69,208,277
2012-11-11 20:00:00,0,0,54,146,200
2012-11-11 21:00:00,0,0,44,127,171
2012-11-11 22:00:00,0,0,21,113,134
2012-11-11 23:00:00,0,0,16,93,109
2012-11-12 00:00:00,1,0,6,43,49
2012-11-12 01:00:00,1,0,4,26,30
2012-11-12 02:00:00,1,0,6,14,20
2012-11-12 03:00:00,1,0,1,3,4
2012-11-12 04:00:00,1,0,1,3,4
2012-11-12 05:00:00,1,0,1,23,24
2012-11-12 06:00:00,1,0,7,64,71
2012-11-12 07:00:00,1,0,16,248,264
2012-11-12 08:00:00,1,0,50,490,540
2012-11-12 09:00:00,1,0,60,337,397
2012-11-12 10:00:00,1,0,82,184,266
2012-11-12 11:00:00,1,0,112,255,367
2012-11-12 12:00:00,1,0,105,314,419
2012-11-12 13:00:00,1,0,108,312,420
2012-11-12 14:00:00,1,0,134,310,444
2012-11-12 15:00:00,1,0,102,280,382
2012-11-12 16:00:00,1,0,87,347,434
2012-11-12 17:00:00,1,0,66,530,596
2012-11-12 18:00:00,1,0,65,486,551
2012-11-12 19:00:00,1,0,30,323,353
2012-11-12 20:00:00,1,0,31,273,304
2012-11-12 21:00:00,1,0,10,145,155
2012-11-12 22:00:00,1,0,12,100,112
2012-11-12 23:00:00,1,0,1,62,63
2012-11-13 00:00:00,0,1,5,18,23
2012-11-13 01:00:00,0,1,0,5,5
2012-11-13 02:00:00,0,1,7,4,11
2012-11-13 03:00:00,0,1,2,3,5
2012-11-13 04:00:00,0,1,0,9,9
2012-11-13 05:00:00,0,1,0,18,18
2012-11-13 06:00:00,0,1,2,48,50
2012-11-13 07:00:00,0,1,1,106,107
2012-11-13 08:00:00,0,1,4,207,211
2012-11-13 09:00:00,0,1,1,109,110
2012-11-13 10:00:00,0,1,10,84,94
2012-11-13 11:00:00,0,1,22,133,155
2012-11-13 12:00:00,0,1,16,180,196
2012-11-13 13:00:00,0,1,30,188,218
2012-11-13 14:00:00,0,1,34,169,203
2012-11-13 15:00:00,0,1,33,184,217
2012-11-13 16:00:00,0,1,28,282,310
2012-11-13 17:00:00,0,1,33,575,608
2012-11-13 18:00:00,0,1,45,514,559
2012-11-13 19:00:00,0,1,12,344,356
2012-11-13 20:00:00,0,1,12,211,223
2012-11-13 21:00:00,0,1,9,178,187
2012-11-13 22:00:00,0,1,15,120,135
2012-11-13 23:00:00,0,1,6,78,84
2012-11-14 00:00:00,0,1,4,20,24
2012-11-14 01:00:00,0,1,2,10,12
2012-11-14 02:00:00,0,1,0,1,1
2012-11-14 03:00:00,0,1,0,5,5
2012-11-14 04:00:00,0,1,0,6,6
2012-11-14 05:00:00,0,1,0,39,39
2012-11-14 06:00:00,0,1,4,142,146
2012-11-14 07:00:00,0,1,10,405,415
2012-11-14 08:00:00,0,1,27,664,691
2012-11-14 09:00:00,0,1,22,310,332
2012-11-14 10:00:00,0,1,18,153,171
2012-11-14 11:00:00,0,1,25,126,151
2012-11-14 12:00:00,0,1,40,200,240
2012-11-14 13:00:00,0,1,32,182,214
2012-11-14 14:00:00,0,1,20,161,181
2012-11-14 15:00:00,0,1,32,228,260
2012-11-14 16:00:00,0,1,31,290,321
2012-11-14 17:00:00,0,1,19,564,583
2012-11-14 18:00:00,0,1,24,543,567
2012-11-14 19:00:00,0,1,28,368,396
2012-11-14 20:00:00,0,1,15,252,267
2012-11-14 21:00:00,0,1,5,208,213
2012-11-14 22:00:00,0,1,6,167,173
2012-11-14 23:00:00,0,1,9,78,87
2012-11-15 00:00:00,0,1,1,33,34
2012-11-15 01:00:00,0,1,2,14,16
2012-11-15 02:00:00,0,1,0,7,7
2012-11-15 03:00:00,0,1,0,2,2
2012-11-15 04:00:00,0,1,0,5,5
2012-11-15 05:00:00,0,1,3,34,37
2012-11-15 06:00:00,0,1,1,146,147
2012-11-15 07:00:00,0,1,7,403,410
2012-11-15 08:00:00,0,1,21,625,646
2012-11-15 09:00:00,0,1,17,306,323
2012-11-15 10:00:00,0,1,11,142,153
2012-11-15 11:00:00,0,1,28,138,166
2012-11-15 12:00:00,0,1,29,184,213
2012-11-15 13:00:00,0,1,20,197,217
2012-11-15 14:00:00,0,1,27,174,201
2012-11-15 15:00:00,0,1,26,191,217
2012-11-15 16:00:00,0,1,24,318,342
2012-11-15 17:00:00,0,1,22,541,563
2012-11-15 18:00:00,0,1,10,563,573
2012-11-15 19:00:00,0,1,11,375,386
2012-11-15 20:00:00,0,1,23,262,285
2012-11-15 21:00:00,0,1,20,204,224
2012-11-15 22:00:00,0,1,10,143,153
2012-11-15 23:00:00,0,1,7,118,125
2012-11-16 00:00:00,0,1,7,58,65
2012-11-16 01:00:00,0,1,5,16,21
2012-11-16 02:00:00,0,1,0,9,9
2012-11-16 03:00:00,0,1,0,6,6
2012-11-16 04:00:00,0,1,0,5,5
2012-11-16 05:00:00,0,1,2,34,36
2012-11-16 06:00:00,0,1,4,126,130
2012-11-16 07:00:00,0,1,5,362,367
2012-11-16 08:00:00,0,1,17,694,711
2012-11-16 09:00:00,0,1,21,330,351
2012-11-16 10:00:00,0,1,33,165,198
2012-11-16 11:00:00,0,1,33,185,218
2012-11-16 12:00:00,0,1,28,262,290
2012-11-16 13:00:00,0,1,52,226,278
2012-11-16 14:00:00,0,1,47,204,251
2012-11-16 15:00:00,0,1,30,237,267
2012-11-16 16:00:00,0,1,33,350,383
2012-11-16 17:00:00,0,1,41,539,580
2012-11-16 18:00:00,0,1,22,483,505
2012-11-16 19:00:00,0,1,26,306,332
2012-11-16 20:00:00,0,1,20,207,227
2012-11-16 21:00:00,0,1,21,157,178
2012-11-16 22:00:00,0,1,23,139,162
2012-11-16 23:00:00,0,1,14,114,128
2012-11-17 00:00:00,0,0,11,95,106
2012-11-17 01:00:00,0,0,13,74,87
2012-11-17 02:00:00,0,0,8,41,49
2012-11-17 03:00:00,0,0,2,19,21
2012-11-17 04:00:00,0,0,1,6,7
2012-11-17 05:00:00,0,0,1,10,11
2012-11-17 06:00:00,0,0,0,21,21
2012-11-17 07:00:00,0,0,8,70,78
2012-11-17 08:00:00,0,0,30,138,168
2012-11-17 09:00:00,0,0,48,200,248
2012-11-17 10:00:00,0,0,62,258,320
2012-11-17 11:00:00,0,0,80,343,423
2012-11-17 12:00:00,0,0,117,359,476
2012-11-17 13:00:00,0,0,179,346,525
2012-11-17 14:00:00,0,0,175,380,555
2012-11-17 15:00:00,0,0,175,374,549
2012-11-17 16:00:00,0,0,144,325,469
2012-11-17 17:00:00,0,0,101,302,403
2012-11-17 18:00:00,0,0,34,237,271
2012-11-17 19:00:00,0,0,45,208,253
2012-11-17 20:00:00,0,0,30,142,172
2012-11-17 21:00:00,0,0,15,124,139
2012-11-17 22:00:00,0,0,15,130,145
2012-11-17 23:00:00,0,0,19,114,133
2012-11-18 00:00:00,0,0,11,118,129
2012-11-18 01:00:00,0,0,14,81,95
2012-11-18 02:00:00,0,0,8,65,73
2012-11-18 03:00:00,0,0,9,37,46
2012-11-18 04:00:00,0,0,4,8,12
2012-11-18 05:00:00,0,0,5,7,12
2012-11-18 06:00:00,0,0,2,13,15
2012-11-18 07:00:00,0,0,3,39,42
2012-11-18 08:00:00,0,0,19,100,119
2012-11-18 09:00:00,0,0,49,155,204
2012-11-18 10:00:00,0,0,79,250,329
2012-11-18 11:00:00,0,0,92,267,359
2012-11-18 12:00:00,0,0,101,341,442
2012-11-18 13:00:00,0,0,113,334,447
2012-11-18 14:00:00,0,0,125,303,428
2012-11-18 15:00:00,0,0,89,318,407
2012-11-18 16:00:00,0,0,59,313,372
2012-11-18 17:00:00,0,0,48,232,280
2012-11-18 18:00:00,0,0,36,240,276
2012-11-18 19:00:00,0,0,16,194,210
2012-11-18 20:00:00,0,0,9,120,129
2012-11-18 21:00:00,0,0,17,93,110
2012-11-18 22:00:00,0,0,8,66,74
2012-11-18 23:00:00,0,0,6,53,59
2012-11-19 00:00:00,0,1,5,22,27
2012-11-19 01:00:00,0,1,0,19,19
2012-11-19 02:00:00,0,1,0,5,5
2012-11-19 03:00:00,0,1,0,2,2
2012-11-19 04:00:00,0,1,1,11,12
2012-11-19 05:00:00,0,1,1,38,39
2012-11-19 06:00:00,0,1,3,128,131
2012-11-19 07:00:00,0,1,5,381,386
2012-11-19 08:00:00,0,1,13,650,663
2012-11-19 09:00:00,0,1,18,260,278
2012-11-19 10:00:00,0,1,33,106,139
2012-11-19 11:00:00,0,1,33,164,197
2012-11-19 12:00:00,0,1,35,207,242
2012-11-19 13:00:00,0,1,46,205,251
2012-11-19 14:00:00,0,1,47,170,217
2012-11-19 15:00:00,0,1,44,213,257
2012-11-19 16:00:00,0,1,55,325,380
2012-11-19 17:00:00,0,1,33,586,619
2012-11-19 18:00:00,0,1,21,559,580
2012-11-19 19:00:00,0,1,25,381,406
2012-11-19 20:00:00,0,1,7,252,259
2012-11-19 21:00:00,0,1,15,188,203
2012-11-19 22:00:00,0,1,7,106,113
2012-11-19 23:00:00,0,1,2,72,74
2012-12-01 00:00:00,0,0,9,99,108
2012-12-01 01:00:00,0,0,5,64,69
2012-12-01 02:00:00,0,0,3,47,50
2012-12-01 03:00:00,0,0,1,14,15
2012-12-01 04:00:00,0,0,0,5,5
2012-12-01 05:00:00,0,0,1,12,13
2012-12-01 06:00:00,0,0,7,20,27
2012-12-01 07:00:00,0,0,7,56,63
2012-12-01 08:00:00,0,0,11,133,144
2012-12-01 09:00:00,0,0,34,159,193
2012-12-01 10:00:00,0,0,45,211,256
2012-12-01 11:00:00,0,0,74,318,392
2012-12-01 12:00:00,0,0,119,327,446
2012-12-01 13:00:00,0,0,123,386,509
2012-12-01 14:00:00,0,0,110,369,479
2012-12-01 15:00:00,0,0,113,371,484
2012-12-01 16:00:00,0,0,89,354,443
2012-12-01 17:00:00,0,0,50,270,320
2012-12-01 18:00:00,0,0,42,255,297
2012-12-01 19:00:00,0,0,30,219,249
2012-12-01 20:00:00,0,0,28,170,198
2012-12-01 21:00:00,0,0,23,135,158
2012-12-01 22:00:00,0,0,17,130,147
2012-12-01 23:00:00,0,0,10,116,126
2012-12-02 00:00:00,0,0,9,108,117
2012-12-02 01:00:00,0,0,10,84,94
2012-12-02 02:00:00,0,0,2,72,74
2012-12-02 03:00:00,0,0,4,21,25
2012-12-02 04:00:00,0,0,1,6,7
2012-12-02 05:00:00,0,0,1,7,8
2012-12-02 06:00:00,0,0,1,15,16
2012-12-02 07:00:00,0,0,5,26,31
2012-12-02 08:00:00,0,0,12,81,93
2012-12-02 09:00:00,0,0,37,135,172
2012-12-02 10:00:00,0,0,63,230,293
2012-12-02 11:00:00,0,0,81,274,355
2012-12-02 12:00:00,0,0,111,409,520
2012-12-02 13:00:00,0,0,84,347,431
2012-12-02 14:00:00,0,0,142,331,473
2012-12-02 15:00:00,0,0,106,311,417
2012-12-02 16:00:00,0,0,85,358,443
2012-12-02 17:00:00,0,0,59,244,303
2012-12-02 18:00:00,0,0,25,178,203
2012-12-02 19:00:00,0,0,16,158,174
2012-12-02 20:00:00,0,0,12,142,154
2012-12-02 21:00:00,0,0,8,91,99
2012-12-02 22:00:00,0,0,11,85,96
2012-12-02 23:00:00,0,0,7,44,51
2012-12-03 00:00:00,0,1,3,18,21
2012-12-03 01:00:00,0,1,2,11,13
2012-12-03 02:00:00,0,1,1,9,10
2012-12-03 03:00:00,0,1,2,6,8
2012-12-03 04:00:00,0,1,1,4,5
2012-12-03 05:00:00,0,1,0,38,38
2012-12-03 06:00:00,0,1,2,136,138
2012-12-03 07:00:00,0,1,9,387,396
2012-12-03 08:00:00,0,1,19,712,731
2012-12-03 09:00:00,0,1,19,289,308
2012-12-03 10:00:00,0,1,31,105,136
2012-12-03 11:00:00,0,1,51,182,233
2012-12-03 12:00:00,0,1,40,228,268
2012-12-03 13:00:00,0,1,81,240,321
2012-12-03 14:00:00,0,1,51,209,260
2012-12-03 15:00:00,0,1,58,210,268
2012-12-03 16:00:00,0,1,45,397,442
2012-12-03 17:00:00,0,1,43,665,708
2012-12-03 18:00:00,0,1,26,666,692
2012-12-03 19:00:00,0,1,27,444,471
2012-12-03 20:00:00,0,1,16,284,300
2012-12-03 21:00:00,0,1,14,207,221
2012-12-03 22:00:00,0,1,5,139,144
2012-12-03 23:00:00,0,1,9,93,102
2012-12-04 00:00:00,0,1,6,49,55
2012-12-04 01:00:00,0,1,3,22,25
2012-12-04 02:00:00,0,1,3,5,8
2012-12-04 03:00:00,0,1,1,3,4
2012-12-04 04:00:00,0,1,0,7,7
2012-12-04 05:00:00,0,1,1,45,46
2012-12-04 06:00:00,0,1,3,150,153
2012-12-04 07:00:00,0,1,7,495,502
2012-12-04 08:00:00,0,1,21,700,721
2012-12-04 09:00:00,0,1,19,317,336
2012-12-04 10:00:00,0,1,26,130,156
2012-12-04 11:00:00,0,1,24,183,207
2012-12-04 12:00:00,0,1,39,273,312
2012-12-04 13:00:00,0,1,39,233,272
2012-12-04 14:00:00,0,1,39,231,270
2012-12-04 15:00:00,0,1,56,244,300
2012-12-04 16:00:00,0,1,44,391,435
2012-12-04 17:00:00,0,1,43,700,743
2012-12-04 18:00:00,0,1,38,693,731
2012-12-04 19:00:00,0,1,46,414,460
2012-12-04 20:00:00,0,1,34,272,306
2012-12-04 21:00:00,0,1,28,252,280
2012-12-04 22:00:00,0,1,26,155,181
2012-12-04 23:00:00,0,1,5,91,96
2012-12-05 00:00:00,0,1,6,31,37
2012-12-05 01:00:00,0,1,0,11,11
2012-12-05 02:00:00,0,1,2,7,9
2012-12-05 03:00:00,0,1,0,7,7
2012-12-05 04:00:00,0,1,1,9,10
2012-12-05 05:00:00,0,1,1,48,49
2012-12-05 06:00:00,0,1,5,119,124
2012-12-05 07:00:00,0,1,9,389,398
2012-12-05 08:00:00,0,1,22,737,759
2012-12-05 09:00:00,0,1,26,362,388
2012-12-05 10:00:00,0,1,14,127,141
2012-12-05 11:00:00,0,1,11,161,172
2012-12-05 12:00:00,0,1,24,208,232
2012-12-05 13:00:00,0,1,14,200,214
2012-12-05 14:00:00,0,1,39,179,218
2012-12-05 15:00:00,0,1,20,265,285
2012-12-05 16:00:00,0,1,23,354,377
2012-12-05 17:00:00,0,1,29,576,605
2012-12-05 18:00:00,0,1,29,580,609
2012-12-05 19:00:00,0,1,14,400,414
2012-12-05 20:00:00,0,1,19,274,293
2012-12-05 21:00:00,0,1,14,184,198
2012-12-05 22:00:00,0,1,4,101,105
2012-12-05 23:00:00,0,1,5,69,74
2012-12-06 00:00:00,0,1,1,43,44
2012-12-06 01:00:00,0,1,0,16,16
2012-12-06 02:00:00,0,1,0,9,9
2012-12-06 03:00:00,0,1,0,2,2
2012-12-06 04:00:00,0,1,1,8,9
2012-12-06 05:00:00,0,1,0,32,32
2012-12-06 06:00:00,0,1,2,122,124
2012-12-06 07:00:00,0,1,8,381,389
2012-12-06 08:00:00,0,1,13,646,659
2012-12-06 09:00:00,0,1,19,257,276
2012-12-06 10:00:00,0,1,23,122,145
2012-12-06 11:00:00,0,1,16,162,178
2012-12-06 12:00:00,0,1,29,206,235
2012-12-06 13:00:00,0,1,33,212,245
2012-12-06 14:00:00,0,1,37,175,212
2012-12-06 15:00:00,0,1,38,232,270
2012-12-06 16:00:00,0,1,39,292,331
2012-12-06 17:00:00,0,1,31,586,617
2012-12-06 18:00:00,0,1,23,542,565
2012-12-06 19:00:00,0,1,13,360,373
2012-12-06 20:00:00,0,1,5,222,227
2012-12-06 21:00:00,0,1,7,184,191
2012-12-06 22:00:00,0,1,2,131,133
2012-12-06 23:00:00,0,1,0,93,93
2012-12-07 00:00:00,0,1,3,45,48
2012-12-07 01:00:00,0,1,2,26,28
2012-12-07 02:00:00,0,1,0,11,11
2012-12-07 03:00:00,0,1,0,5,5
2012-12-07 04:00:00,0,1,0,10,10
2012-12-07 05:00:00,0,1,1,25,26
2012-12-07 06:00:00,0,1,0,84,84
2012-12-07 07:00:00,0,1,3,212,215
2012-12-07 08:00:00,0,1,11,430,441
2012-12-07 09:00:00,0,1,10,291,301
2012-12-07 10:00:00,0,1,16,150,166
2012-12-07 11:00:00,0,1,20,183,203
2012-12-07 12:00:00,0,1,36,204,240
2012-12-07 13:00:00,0,1,23,197,220
2012-12-07 14:00:00,0,1,40,175,215
2012-12-07 15:00:00,0,1,34,269,303
2012-12-07 16:00:00,0,1,39,336,375
2012-12-07 17:00:00,0,1,29,539,568
2012-12-07 18:00:00,0,1,25,473,498
2012-12-07 19:00:00,0,1,15,337,352
2012-12-07 20:00:00,0,1,12,229,241
2012-12-07 21:00:00,0,1,9,162,171
2012-12-07 22:00:00,0,1,15,150,165
2012-12-07 23:00:00,0,1,6,116,122
2012-12-08 00:00:00,0,0,5,98,103
2012-12-08 01:00:00,0,0,16,84,100
2012-12-08 02:00:00,0,0,3,67,70
2012-12-08 03:00:00,0,0,6,23,29
2012-12-08 04:00:00,0,0,3,9,12
2012-12-08 05:00:00,0,0,2,4,6
2012-12-08 06:00:00,0,0,1,19,20
2012-12-08 07:00:00,0,0,3,36,39
2012-12-08 08:00:00,0,0,5,106,111
2012-12-08 09:00:00,0,0,17,153,170
2012-12-08 10:00:00,0,0,43,244,287
2012-12-08 11:00:00,0,0,63,341,404
2012-12-08 12:00:00,0,0,122,364,486
2012-12-08 13:00:00,0,0,148,399,547
2012-12-08 14:00:00,0,0,164,378,542
2012-12-08 15:00:00,0,0,167,374,541
2012-12-08 16:00:00,0,0,139,368,507
2012-12-08 17:00:00,0,0,77,268,345
2012-12-08 18:00:00,0,0,40,264,304
2012-12-08 19:00:00,0,0,34,212,246
2012-12-08 20:00:00,0,0,20,162,182
2012-12-08 21:00:00,0,0,34,175,209
2012-12-08 22:00:00,0,0,23,137,160
2012-12-08 23:00:00,0,0,18,144,162
2012-12-09 00:00:00,0,0,15,103,118
2012-12-09 01:00:00,0,0,17,85,102
2012-12-09 02:00:00,0,0,8,70,78
2012-12-09 03:00:00,0,0,14,34,48
2012-12-09 04:00:00,0,0,1,11,12
2012-12-09 05:00:00,0,0,0,8,8
2012-12-09 06:00:00,0,0,0,6,6
2012-12-09 07:00:00,0,0,1,22,23
2012-12-09 08:00:00,0,0,1,68,69
2012-12-09 09:00:00,0,0,9,94,103
2012-12-09 10:00:00,0,0,39,180,219
2012-12-09 11:00:00,0,0,40,210,250
2012-12-09 12:00:00,0,0,60,255,315
2012-12-09 13:00:00,0,0,65,220,285
2012-12-09 14:00:00,0,0,42,190,232
2012-12-09 15:00:00,0,0,25,200,225
2012-12-09 16:00:00,0,0,33,220,253
2012-12-09 17:00:00,0,0,20,209,229
2012-12-09 18:00:00,0,0,17,181,198
2012-12-09 19:00:00,0,0,12,110,122
2012-12-09 20:00:00,0,0,6,102,108
2012-12-09 21:00:00,0,0,10,86,96
2012-12-09 22:00:00,0,0,3,75,78
2012-12-09 23:00:00,0,0,3,48,51
2012-12-10 00:00:00,0,1,0,20,20
2012-12-10 01:00:00,0,1,0,4,4
2012-12-10 02:00:00,0,1,2,3,5
2012-12-10 03:00:00,0,1,0,4,4
2012-12-10 04:00:00,0,1,3,9,12
2012-12-10 05:00:00,0,1,0,27,27
2012-12-10 06:00:00,0,1,2,121,123
2012-12-10 07:00:00,0,1,3,291,294
2012-12-10 08:00:00,0,1,9,575,584
2012-12-10 09:00:00,0,1,11,273,284
2012-12-10 10:00:00,0,1,12,121,133
2012-12-10 11:00:00,0,1,8,126,134
2012-12-10 12:00:00,0,1,23,150,173
2012-12-10 13:00:00,0,1,30,190,220
2012-12-10 14:00:00,0,1,31,179,210
2012-12-10 15:00:00,0,1,29,207,236
2012-12-10 16:00:00,0,1,37,308,345
2012-12-10 17:00:00,0,1,38,578,616
2012-12-10 18:00:00,0,1,20,544,564
2012-12-10 19:00:00,0,1,18,409,427
2012-12-10 20:00:00,0,1,13,287,300
2012-12-10 21:00:00,0,1,21,224,245
2012-12-10 22:00:00,0,1,11,115,126
2012-12-10 23:00:00,0,1,8,76,84
2012-12-11 00:00:00,0,1,2,29,31
2012-12-11 01:00:00,0,1,1,7,8
2012-12-11 02:00:00,0,1,0,1,1
2012-12-11 03:00:00,0,1,0,3,3
2012-12-11 04:00:00,0,1,0,8,8
2012-12-11 05:00:00,0,1,1,40,41
2012-12-11 06:00:00,0,1,0,118,118
2012-12-11 07:00:00,0,1,8,372,380
2012-12-11 08:00:00,0,1,16,708,724
2012-12-11 09:00:00,0,1,12,322,334
2012-12-11 10:00:00,0,1,12,142,154
2012-12-11 11:00:00,0,1,28,145,173
2012-12-11 12:00:00,0,1,13,213,226
2012-12-11 13:00:00,0,1,28,226,254
2012-12-11 14:00:00,0,1,19,185,204
2012-12-11 15:00:00,0,1,20,250,270
2012-12-11 16:00:00,0,1,24,334,358
2012-12-11 17:00:00,0,1,21,580,601
2012-12-11 18:00:00,0,1,23,523,546
2012-12-11 19:00:00,0,1,21,412,433
2012-12-11 20:00:00,0,1,9,248,257
2012-12-11 21:00:00,0,1,14,193,207
2012-12-11 22:00:00,0,1,6,100,106
2012-12-11 23:00:00,0,1,4,60,64
2012-12-12 00:00:00,0,1,1,33,34
2012-12-12 01:00:00,0,1,3,18,21
2012-12-12 02:00:00,0,1,5,4,9
2012-12-12 03:00:00,0,1,3,7,10
2012-12-12 04:00:00,0,1,0,4,4
2012-12-12 05:00:00,0,1,0,37,37
2012-12-12 06:00:00,0,1,2,126,128
2012-12-12 07:00:00,0,1,3,366,369
2012-12-12 08:00:00,0,1,18,670,688
2012-12-12 09:00:00,0,1,13,272,285
2012-12-12 10:00:00,0,1,20,116,136
2012-12-12 11:00:00,0,1,24,148,172
2012-12-12 12:00:00,0,1,14,218,232
2012-12-12 13:00:00,0,1,18,220,238
2012-12-12 14:00:00,0,1,34,191,225
2012-12-12 15:00:00,0,1,21,207,228
2012-12-12 16:00:00,0,1,19,310,329
2012-12-12 17:00:00,0,1,21,540,561
2012-12-12 18:00:00,0,1,25,515,540
2012-12-12 19:00:00,0,1,18,384,402
2012-12-12 20:00:00,0,1,25,243,268
2012-12-12 21:00:00,0,1,16,186,202
2012-12-12 22:00:00,0,1,4,118,122
2012-12-12 23:00:00,0,1,3,76,79
2012-12-13 00:00:00,0,1,1,31,32
2012-12-13 01:00:00,0,1,4,19,23
2012-12-13 02:00:00,0,1,3,5,8
2012-12-13 03:00:00,0,1,0,2,2
2012-12-13 04:00:00,0,1,0,8,8
2012-12-13 05:00:00,0,1,2,31,33
2012-12-13 06:00:00,0,1,2,112,114
2012-12-13 07:00:00,0,1,5,380,385
2012-12-13 08:00:00,0,1,24,655,679
2012-12-13 09:00:00,0,1,25,300,325
2012-12-13 10:00:00,0,1,28,139,167
2012-12-13 11:00:00,0,1,25,164,189
2012-12-13 12:00:00,0,1,30,252,282
2012-12-13 13:00:00,0,1,41,230,271
2012-12-13 14:00:00,0,1,31,211,242
2012-12-13 15:00:00,0,1,40,240,280
2012-12-13 16:00:00,0,1,50,356,406
2012-12-13 17:00:00,0,1,43,507,550
2012-12-13 18:00:00,0,1,20,446,466
2012-12-13 19:00:00,0,1,20,328,348
2012-12-13 20:00:00,0,1,6,235,241
2012-12-13 21:00:00,0,1,13,200,213
2012-12-13 22:00:00,0,1,7,141,148
2012-12-13 23:00:00,0,1,5,115,120
2012-12-14 00:00:00,0,1,4,43,47
2012-12-14 01:00:00,0,1,0,26,26
2012-12-14 02:00:00,0,1,3,6,9
2012-12-14 03:00:00,0,1,0,12,12
2012-12-14 04:00:00,0,1,1,9,10
2012-12-14 05:00:00,0,1,0,34,34
2012-12-14 06:00:00,0,1,1,112,113
2012-12-14 07:00:00,0,1,3,305,308
2012-12-14 08:00:00,0,1,13,623,636
2012-12-14 09:00:00,0,1,13,330,343
2012-12-14 10:00:00,0,1,28,162,190
2012-12-14 11:00:00,0,1,31,180,211
2012-12-14 12:00:00,0,1,29,244,273
2012-12-14 13:00:00,0,1,39,274,313
2012-12-14 14:00:00,0,1,48,251,299
2012-12-14 15:00:00,0,1,57,252,309
2012-12-14 16:00:00,0,1,45,372,417
2012-12-14 17:00:00,0,1,40,582,622
2012-12-14 18:00:00,0,1,23,432,455
2012-12-14 19:00:00,0,1,17,302,319
2012-12-14 20:00:00,0,1,12,209,221
2012-12-14 21:00:00,0,1,7,165,172
2012-12-14 22:00:00,0,1,4,134,138
2012-12-14 23:00:00,0,1,11,123,134
2012-12-15 00:00:00,0,0,4,90,94
2012-12-15 01:00:00,0,0,9,86,95
2012-12-15 02:00:00,0,0,6,63,69
2012-12-15 03:00:00,0,0,5,18,23
2012-12-15 04:00:00,0,0,1,5,6
2012-12-15 05:00:00,0,0,0,3,3
2012-12-15 06:00:00,0,0,0,11,11
2012-12-15 07:00:00,0,0,1,47,48
2012-12-15 08:00:00,0,0,8,111,119
2012-12-15 09:00:00,0,0,17,203,220
2012-12-15 10:00:00,0,0,23,250,273
2012-12-15 11:00:00,0,0,66,327,393
2012-12-15 12:00:00,0,0,89,364,453
2012-12-15 13:00:00,0,0,88,368,456
2012-12-15 14:00:00,0,0,92,334,426
2012-12-15 15:00:00,0,0,95,352,447
2012-12-15 16:00:00,0,0,85,328,413
2012-12-15 17:00:00,0,0,35,274,309
2012-12-15 18:00:00,0,0,40,232,272
2012-12-15 19:00:00,0,0,32,225,257
2012-12-15 20:00:00,0,0,23,178,201
2012-12-15 21:00:00,0,0,15,169,184
2012-12-15 22:00:00,0,0,22,134,156
2012-12-15 23:00:00,0,0,11,108,119
2012-12-16 00:00:00,0,0,8,102,110
2012-12-16 01:00:00,0,0,14,82,96
2012-12-16 02:00:00,0,0,8,79,87
2012-12-16 03:00:00,0,0,1,37,38
2012-12-16 04:00:00,0,0,1,10,11
2012-12-16 05:00:00,0,0,0,9,9
2012-12-16 06:00:00,0,0,0,6,6
2012-12-16 07:00:00,0,0,5,22,27
2012-12-16 08:00:00,0,0,12,76,88
2012-12-16 09:00:00,0,0,19,113,132
2012-12-16 10:00:00,0,0,42,215,257
2012-12-16 11:00:00,0,0,47,248,295
2012-12-16 12:00:00,0,0,67,350,417
2012-12-16 13:00:00,0,0,67,289,356
2012-12-16 14:00:00,0,0,50,260,310
2012-12-16 15:00:00,0,0,46,292,338
2012-12-16 16:00:00,0,0,66,334,400
2012-12-16 17:00:00,0,0,29,214,243
2012-12-16 18:00:00,0,0,8,99,107
2012-12-16 19:00:00,0,0,10,99,109
2012-12-16 20:00:00,0,0,14,108,122
2012-12-16 21:00:00,0,0,14,92,106
2012-12-16 22:00:00,0,0,6,83,89
2012-12-16 23:00:00,0,0,4,29,33
2012-12-17 00:00:00,0,1,2,26,28
2012-12-17 01:00:00,0,1,1,14,15
2012-12-17 02:00:00,0,1,1,4,5
2012-12-17 03:00:00,0,1,0,3,3
2012-12-17 04:00:00,0,1,2,3,5
2012-12-17 05:00:00,0,1,0,24,24
2012-12-17 06:00:00,0,1,1,107,108
2012-12-17 07:00:00,0,1,5,314,319
2012-12-17 08:00:00,0,1,10,582,592
2012-12-17 09:00:00,0,1,11,271,282
2012-12-17 10:00:00,0,1,15,120,135
2012-12-17 11:00:00,0,1,22,148,170
2012-12-17 12:00:00,0,1,21,211,232
2012-12-17 13:00:00,0,1,16,194,210
2012-12-17 14:00:00,0,1,12,169,181
2012-12-17 15:00:00,0,1,15,196,211
2012-12-17 16:00:00,0,1,15,287,302
2012-12-17 17:00:00,0,1,17,478,495
2012-12-17 18:00:00,0,1,14,493,507
2012-12-17 19:00:00,0,1,7,333,340
2012-12-17 20:00:00,0,1,8,192,200
2012-12-17 21:00:00,0,1,6,114,120
2012-12-17 22:00:00,0,1,5,49,54
2012-12-17 23:00:00,0,1,6,41,47
2012-12-18 00:00:00,0,1,0,18,18
2012-12-18 01:00:00,0,1,0,15,15
2012-12-18 02:00:00,0,1,2,5,7
2012-12-18 03:00:00,0,1,0,5,5
2012-12-18 04:00:00,0,1,3,5,8
2012-12-18 05:00:00,0,1,0,36,36
2012-12-18 06:00:00,0,1,1,117,118
2012-12-18 07:00:00,0,1,4,351,355
2012-12-18 08:00:00,0,1,10,652,662
2012-12-18 09:00:00,0,1,19,307,326
2012-12-18 10:00:00,0,1,22,162,184
2012-12-18 11:00:00,0,1,58,211,269
2012-12-18 12:00:00,0,1,49,264,313
2012-12-18 13:00:00,0,1,51,235,286
2012-12-18 14:00:00,0,1,56,191,247
2012-12-18 15:00:00,0,1,28,218,246
2012-12-18 16:00:00,0,1,40,323,363
2012-12-18 17:00:00,0,1,39,533,572
2012-12-18 18:00:00,0,1,13,512,525
2012-12-18 19:00:00,0,1,19,334,353
2012-12-18 20:00:00,0,1,4,264,268
2012-12-18 21:00:00,0,1,9,159,168
2012-12-18 22:00:00,0,1,5,127,132
2012-12-18 23:00:00,0,1,1,80,81
2012-12-19 00:00:00,0,1,6,35,41
2012-12-19 01:00:00,0,1,1,14,15
2012-12-19 02:00:00,0,1,1,2,3
2012-12-19 03:00:00,0,1,0,5,5
2012-12-19 04:00:00,0,1,1,6,7
2012-12-19 05:00:00,0,1,2,29,31
2012-12-19 06:00:00,0,1,3,109,112
2012-12-19 07:00:00,0,1,3,360,363
2012-12-19 08:00:00,0,1,13,665,678
2012-12-19 09:00:00,0,1,8,309,317
2012-12-19 10:00:00,0,1,17,147,164
2012-12-19 11:00:00,0,1,31,169,200
2012-12-19 12:00:00,0,1,33,203,236
2012-12-19 13:00:00,0,1,30,183,213
2012-12-19 14:00:00,0,1,33,185,218
2012-12-19 15:00:00,0,1,28,209,237
2012-12-19 16:00:00,0,1,37,297,334
2012-12-19 17:00:00,0,1,26,536,562
2012-12-19 18:00:00,0,1,23,546,569
2012-12-19 19:00:00,0,1,7,329,336
2012-12-19 20:00:00,0,1,10,231,241
2012-12-19 21:00:00,0,1,4,164,168
2012-12-19 22:00:00,0,1,12,117,129
2012-12-19 23:00:00,0,1,4,84,88
